PokerStars Zoom Hand #210155993732:  Hold'em No Limit (€0.01/€0.02) - 2020/03/15 14:33:10 CET [2020/03/15 9:33:10 ET]
Table 'Arneb' 6-max Seat #1 is the button
Seat 1: Luckers712 (€1.97 in chips)
Seat 2: Javibasket17 (€2.41 in chips)
Seat 3: Veesile (€2 in chips)
Seat 4: j om13015 (€1.15 in chips)
Seat 5: senruedas_ (€2 in chips)
Seat 6: NanoLMP (€2.46 in chips)
Javibasket17: posts small blind €0.01
Veesile: posts big blind €0.02
*** HOLE CARDS ***
Dealt to Luckers712 [Tc Kh]
j om13015: calls €0.02
senruedas_: folds
NanoLMP: folds
Luckers712: raises €0.03 to €0.05
Javibasket17: folds
Veesile: folds
j om13015: raises €0.05 to €0.10
Luckers712: calls €0.05
*** FLOP *** [8s Ks 5s]
j om13015: bets €0.04
Luckers712: raises €0.04 to €0.08
j om13015: calls €0.04
*** TURN *** [8s Ks 5s] [Qs]
j om13015: bets €0.06
Luckers712: calls €0.06
*** RIVER *** [8s Ks 5s Qs] [2d]
j om13015: bets €0.06
Luckers712: calls €0.06
*** SHOW DOWN ***
j om13015: shows [9d 9s] (a flush, King high)
Luckers712: mucks hand
j om13015 collected €0.60 from pot
*** SUMMARY ***
Total pot €0.63 | Rake €0.03
Board [8s Ks 5s Qs 2d]
Seat 1: Luckers712 (button) mucked [Tc Kh]
Seat 2: Javibasket17 (small blind) folded before Flop
Seat 3: Veesile (big blind) folded before Flop
Seat 4: j om13015 showed [9d 9s] and won (€0.60) with a flush, King high
Seat 5: senruedas_ folded before Flop (didn't bet)
Seat 6: NanoLMP folded before Flop (didn't bet)



PokerStars Hand #197051178017:  Hold'em No Limit (€0.01/€0.02 EUR) - 2019/02/14 21:02:31 CET [2019/02/14 15:02:31 ET]
Table 'Phobos III' 6-max Seat #6 is the button
Seat 1: azi fou (€1.85 in chips)
Seat 2: Luckers712 (€2 in chips)
Seat 4: finistere6 (€7.22 in chips)
Seat 5: Kyser2023 (€2.31 in chips)
Seat 6: HarryCovert35 (€2 in chips)
azi fou: posts small blind €0.01
Luckers712: posts big blind €0.02
groseil is connected
groseil: sits out
*** HOLE CARDS ***
Dealt to Luckers712 [2s 4d]
finistere6: folds
Kyser2023: raises €0.04 to €0.06
HarryCovert35: folds
azi fou: raises €0.04 to €0.10
Luckers712: folds
Kyser2023: calls €0.04
*** FLOP *** [8h 8s Js]
azi fou: bets €0.10
Kyser2023: folds
Uncalled bet (€0.10) returned to azi fou
azi fou collected €0.21 from pot
azi fou: doesn't show hand
*** SUMMARY ***
Total pot €0.22 | Rake €0.01
Board [8h 8s Js]
Seat 1: azi fou (small blind) collected (€0.21)
Seat 2: Luckers712 (big blind) folded before Flop
Seat 4: finistere6 folded before Flop (didn't bet)
Seat 5: Kyser2023 folded on the Flop
Seat 6: HarryCovert35 (button) folded before Flop (didn't bet)



PokerStars Zoom Hand #210155983217:  Hold'em No Limit (€0.01/€0.02) - 2020/03/15 14:32:52 CET [2020/03/15 9:32:52 ET]
Table 'Arneb' 6-max Seat #1 is the button
Seat 1: riazorclub (€1.97 in chips)
Seat 2: RSFr3ItasS_08 (€2.45 in chips)
Seat 3: Luckers712 (€2 in chips)
Seat 4: Bwotah (€6.23 in chips)
Seat 5: Vitorhcsousa (€4.93 in chips)
Seat 6: ekzemaker (€5.30 in chips)
RSFr3ItasS_08: posts small blind €0.01
Luckers712: posts big blind €0.02
*** HOLE CARDS ***
Dealt to Luckers712 [9c 5h]
Bwotah: folds
Vitorhcsousa: folds
ekzemaker: raises €0.02 to €0.04
riazorclub: folds
RSFr3ItasS_08: folds
Luckers712: folds
Uncalled bet (€0.02) returned to ekzemaker
ekzemaker collected €0.05 from pot
*** SUMMARY ***
Total pot €0.05 | Rake €0
Seat 1: riazorclub (button) folded before Flop (didn't bet)
Seat 2: RSFr3ItasS_08 (small blind) folded before Flop
Seat 3: Luckers712 (big blind) folded before Flop
Seat 4: Bwotah folded before Flop (didn't bet)
Seat 5: Vitorhcsousa folded before Flop (didn't bet)
Seat 6: ekzemaker collected (€0.05)



PokerStars Zoom Hand #210155988904:  Hold'em No Limit (€0.01/€0.02) - 2020/03/15 14:33:02 CET [2020/03/15 9:33:02 ET]
Table 'Arneb' 6-max Seat #1 is the button
Seat 1: riazorclub (€2 in chips)
Seat 2: Luckers712 (€1.98 in chips)
Seat 3: FreudMind (€0.74 in chips)
Seat 4: thewithman (€3.33 in chips)
Seat 5: Veesile (€2.22 in chips)
Seat 6: ciclo230385 (€5.65 in chips)
Luckers712: posts small blind €0.01
FreudMind: posts big blind €0.02
*** HOLE CARDS ***
Dealt to Luckers712 [2h 2c]
thewithman: raises €0.05 to €0.07
Veesile: folds
ciclo230385: folds
riazorclub: folds
Luckers712: folds
FreudMind: calls €0.05
*** FLOP *** [Qc 9c Jh]
FreudMind: checks
thewithman: bets €0.07
FreudMind: folds
Uncalled bet (€0.07) returned to thewithman
thewithman collected €0.14 from pot
thewithman: doesn't show hand
*** SUMMARY ***
Total pot €0.15 | Rake €0.01
Board [Qc 9c Jh]
Seat 1: riazorclub (button) folded before Flop (didn't bet)
Seat 2: Luckers712 (small blind) folded before Flop
Seat 3: FreudMind (big blind) folded on the Flop
Seat 4: thewithman collected (€0.14)
Seat 5: Veesile folded before Flop (didn't bet)
Seat 6: ciclo230385 folded before Flop (didn't bet)



PokerStars Zoom Hand #210155993732:  Hold'em No Limit (€0.01/€0.02) - 2020/03/15 14:33:10 CET [2020/03/15 9:33:10 ET]
Table 'Arneb' 6-max Seat #1 is the button
Seat 1: Luckers712 (€1.97 in chips)
Seat 2: Javibasket17 (€2.41 in chips)
Seat 3: Veesile (€2 in chips)
Seat 4: j om13015 (€1.15 in chips)
Seat 5: senruedas_ (€2 in chips)
Seat 6: NanoLMP (€2.46 in chips)
Javibasket17: posts small blind €0.01
Veesile: posts big blind €0.02
*** HOLE CARDS ***
Dealt to Luckers712 [Tc Kh]
j om13015: calls €0.02
senruedas_: folds
NanoLMP: folds
Luckers712: raises €0.03 to €0.05
Javibasket17: folds
Veesile: folds
j om13015: raises €0.05 to €0.10
Luckers712: calls €0.05
*** FLOP *** [8s Ks 5s]
j om13015: bets €0.04
Luckers712: raises €0.04 to €0.08
j om13015: calls €0.04
*** TURN *** [8s Ks 5s] [Qs]
j om13015: bets €0.06
Luckers712: calls €0.06
*** RIVER *** [8s Ks 5s Qs] [2d]
j om13015: bets €0.06
Luckers712: calls €0.06
*** SHOW DOWN ***
j om13015: shows [9d 9s] (a flush, King high)
Luckers712: mucks hand
j om13015 collected €0.60 from pot
*** SUMMARY ***
Total pot €0.63 | Rake €0.03
Board [8s Ks 5s Qs 2d]
Seat 1: Luckers712 (button) mucked [Tc Kh]
Seat 2: Javibasket17 (small blind) folded before Flop
Seat 3: Veesile (big blind) folded before Flop
Seat 4: j om13015 showed [9d 9s] and won (€0.60) with a flush, King high
Seat 5: senruedas_ folded before Flop (didn't bet)
Seat 6: NanoLMP folded before Flop (didn't bet)



PokerStars Zoom Hand #210156041164:  Hold'em No Limit (€0.01/€0.02) - 2020/03/15 14:34:30 CET [2020/03/15 9:34:30 ET]
Table 'Arneb' 6-max Seat #1 is the button
Seat 1: DNooXLvv (€6.10 in chips)
Seat 2: pzjohn (€4.04 in chips)
Seat 3: jeanba95320 (€2.42 in chips)
Seat 4: Rppopy (€2.80 in chips)
Seat 5: Raulinho807 (€1.14 in chips)
Seat 6: Luckers712 (€1.70 in chips)
pzjohn: posts small blind €0.01
jeanba95320: posts big blind €0.02
*** HOLE CARDS ***
Dealt to Luckers712 [8s 3h]
Rppopy: folds
Raulinho807: folds
Luckers712: folds
DNooXLvv: folds
pzjohn: folds
Uncalled bet (€0.01) returned to jeanba95320
jeanba95320 collected €0.02 from pot
jeanba95320: doesn't show hand
*** SUMMARY ***
Total pot €0.02 | Rake €0
Seat 1: DNooXLvv (button) folded before Flop (didn't bet)
Seat 2: pzjohn (small blind) folded before Flop
Seat 3: jeanba95320 (big blind) collected (€0.02)
Seat 4: Rppopy folded before Flop (didn't bet)
Seat 5: Raulinho807 folded before Flop (didn't bet)
Seat 6: Luckers712 folded before Flop (didn't bet)



PokerStars Zoom Hand #210156047173:  Hold'em No Limit (€0.01/€0.02) - 2020/03/15 14:34:40 CET [2020/03/15 9:34:40 ET]
Table 'Arneb' 6-max Seat #1 is the button
Seat 1: JujunGele (€2.39 in chips)
Seat 2: triatlon23 (€2.06 in chips)
Seat 3: Makarenu (€1.94 in chips)
Seat 4: laescort (€2 in chips)
Seat 5: Luckers712 (€2 in chips)
Seat 6: saulb16 (€2.28 in chips)
triatlon23: posts small blind €0.01
Makarenu: posts big blind €0.02
*** HOLE CARDS ***
Dealt to Luckers712 [9c Qd]
laescort: folds
Luckers712: folds
saulb16: raises €0.04 to €0.06
JujunGele: folds
triatlon23: folds
Makarenu: raises €0.13 to €0.19
saulb16: folds
Uncalled bet (€0.13) returned to Makarenu
Makarenu collected €0.13 from pot
Makarenu: doesn't show hand
*** SUMMARY ***
Total pot €0.13 | Rake €0
Seat 1: JujunGele (button) folded before Flop (didn't bet)
Seat 2: triatlon23 (small blind) folded before Flop
Seat 3: Makarenu (big blind) collected (€0.13)
Seat 4: laescort folded before Flop (didn't bet)
Seat 5: Luckers712 folded before Flop (didn't bet)
Seat 6: saulb16 folded before Flop



PokerStars Zoom Hand #210156051347:  Hold'em No Limit (€0.01/€0.02) - 2020/03/15 14:34:47 CET [2020/03/15 9:34:47 ET]
Table 'Arneb' 6-max Seat #1 is the button
Seat 1: Veesile (€2 in chips)
Seat 2: Luckers712 (€2 in chips)
Seat 3: HeKaDeNuuK (€2 in chips)
Seat 4: ID047 (€2.85 in chips)
Seat 5: raulbeni (€2.04 in chips)
Seat 6: RedmiPro4 (€1.94 in chips)
Luckers712: posts small blind €0.01
HeKaDeNuuK: posts big blind €0.02
*** HOLE CARDS ***
Dealt to Luckers712 [4h 4c]
ID047: raises €0.05 to €0.07
raulbeni: folds
RedmiPro4: folds
Veesile: folds
Luckers712: calls €0.06
HeKaDeNuuK: calls €0.05
*** FLOP *** [Ts 2c 2d]
Luckers712: checks
HeKaDeNuuK: checks
ID047: checks
*** TURN *** [Ts 2c 2d] [As]
Luckers712: checks
HeKaDeNuuK: checks
ID047: bets €0.11
Luckers712: folds
HeKaDeNuuK: folds
Uncalled bet (€0.11) returned to ID047
ID047 collected €0.20 from pot
ID047: doesn't show hand
*** SUMMARY ***
Total pot €0.21 | Rake €0.01
Board [Ts 2c 2d As]
Seat 1: Veesile (button) folded before Flop (didn't bet)
Seat 2: Luckers712 (small blind) folded on the Turn
Seat 3: HeKaDeNuuK (big blind) folded on the Turn
Seat 4: ID047 collected (€0.20)
Seat 5: raulbeni folded before Flop (didn't bet)
Seat 6: RedmiPro4 folded before Flop (didn't bet)



PokerStars Zoom Hand #210156084836:  Hold'em No Limit (€0.01/€0.02) - 2020/03/15 14:35:44 CET [2020/03/15 9:35:44 ET]
Table 'Arneb' 6-max Seat #1 is the button
Seat 1: kattalintxo (€2.63 in chips)
Seat 2: pacacas (€2.24 in chips)
Seat 3: Luckers712 (€2 in chips)
Seat 4: DNooXLvv (€2.03 in chips)
Seat 5: feelling1980 (€2.42 in chips)
Seat 6: Javibasket17 (€2.71 in chips)
pacacas: posts small blind €0.01
Luckers712: posts big blind €0.02
*** HOLE CARDS ***
Dealt to Luckers712 [4s Qc]
DNooXLvv: folds
feelling1980: folds
Javibasket17: raises €0.04 to €0.06
kattalintxo: folds
pacacas: calls €0.05
Luckers712: calls €0.04
*** FLOP *** [2d 2c 5d]
pacacas: checks
Luckers712: checks
Javibasket17: checks
*** TURN *** [2d 2c 5d] [3s]
pacacas: checks
Luckers712: checks
Javibasket17: checks
*** RIVER *** [2d 2c 5d 3s] [Jc]
pacacas: checks
Luckers712: checks
Javibasket17: checks
*** SHOW DOWN ***
pacacas: shows [Jh Qs] (two pair, Jacks and Deuces)
Luckers712: mucks hand
Javibasket17: mucks hand
pacacas collected €0.17 from pot
*** SUMMARY ***
Total pot €0.18 | Rake €0.01
Board [2d 2c 5d 3s Jc]
Seat 1: kattalintxo (button) folded before Flop (didn't bet)
Seat 2: pacacas (small blind) showed [Jh Qs] and won (€0.17) with two pair, Jacks and Deuces
Seat 3: Luckers712 (big blind) mucked [4s Qc]
Seat 4: DNooXLvv folded before Flop (didn't bet)
Seat 5: feelling1980 folded before Flop (didn't bet)
Seat 6: Javibasket17 mucked [9c Ah]



PokerStars Zoom Hand #210156120750:  Hold'em No Limit (€0.01/€0.02) - 2020/03/15 14:36:45 CET [2020/03/15 9:36:45 ET]
Table 'Arneb' 6-max Seat #1 is the button
Seat 1: Luckers712 (€1.93 in chips)
Seat 2: Makarenu (€3.83 in chips)
Seat 3: mue_16v (€2 in chips)
Seat 4: Danster1968 (€2.19 in chips)
Seat 5: Rppopy (€2.85 in chips)
Seat 6: Zé Zé Sete (€2.04 in chips)
Makarenu: posts small blind €0.01
mue_16v: posts big blind €0.02
*** HOLE CARDS ***
Dealt to Luckers712 [6c 6s]
Danster1968: folds
Rppopy: folds
Zé Zé Sete: folds
Luckers712: raises €0.03 to €0.05
Makarenu: folds
mue_16v: raises €0.15 to €0.20
Luckers712: folds
Uncalled bet (€0.15) returned to mue_16v
mue_16v collected €0.11 from pot
mue_16v: doesn't show hand
*** SUMMARY ***
Total pot €0.11 | Rake €0
Seat 1: Luckers712 (button) folded before Flop
Seat 2: Makarenu (small blind) folded before Flop
Seat 3: mue_16v (big blind) collected (€0.11)
Seat 4: Danster1968 folded before Flop (didn't bet)
Seat 5: Rppopy folded before Flop (didn't bet)
Seat 6: Zé Zé Sete folded before Flop (didn't bet)



PokerStars Zoom Hand #210156118348:  Hold'em No Limit (€0.01/€0.02) - 2020/03/15 14:36:41 CET [2020/03/15 9:36:41 ET]
Table 'Arneb' 6-max Seat #1 is the button
Seat 1: riazorclub (€2.72 in chips)
Seat 2: Luckers712 (€1.94 in chips)
Seat 3: JOHNNYDU42 (€2.97 in chips)
Seat 4: detlef (€2 in chips)
Seat 5: Rppopy (€2.85 in chips)
Seat 6: Dgcaro08 (€1.38 in chips)
Luckers712: posts small blind €0.01
JOHNNYDU42: posts big blind €0.02
*** HOLE CARDS ***
Dealt to Luckers712 [5s Tc]
detlef: folds
Rppopy: folds
Dgcaro08: calls €0.02
riazorclub: folds
Luckers712: folds
JOHNNYDU42: checks
*** FLOP *** [7h 3d Qd]
JOHNNYDU42: checks
Dgcaro08: bets €0.04
JOHNNYDU42: folds
Uncalled bet (€0.04) returned to Dgcaro08
Dgcaro08 collected €0.05 from pot
Dgcaro08: doesn't show hand
*** SUMMARY ***
Total pot €0.05 | Rake €0
Board [7h 3d Qd]
Seat 1: riazorclub (button) folded before Flop (didn't bet)
Seat 2: Luckers712 (small blind) folded before Flop
Seat 3: JOHNNYDU42 (big blind) folded on the Flop
Seat 4: detlef folded before Flop (didn't bet)
Seat 5: Rppopy folded before Flop (didn't bet)
Seat 6: Dgcaro08 collected (€0.05)



PokerStars Zoom Hand #210156130653:  Hold'em No Limit (€0.01/€0.02) - 2020/03/15 14:37:02 CET [2020/03/15 9:37:02 ET]
Table 'Arneb' 6-max Seat #1 is the button
Seat 1: campanilla06 (€2.36 in chips)
Seat 2: Veesile (€2.06 in chips)
Seat 3: NanoLMP (€2.39 in chips)
Seat 4: Sespir (€3.24 in chips)
Seat 5: ToniMarteens (€1.03 in chips)
Seat 6: Luckers712 (€1.95 in chips)
Veesile: posts small blind €0.01
NanoLMP: posts big blind €0.02
*** HOLE CARDS ***
Dealt to Luckers712 [5c 2h]
Sespir: folds
ToniMarteens: folds
Luckers712: folds
campanilla06: folds
Veesile: raises €0.04 to €0.06
NanoLMP: calls €0.04
*** FLOP *** [Kc 2s 6h]
Veesile: checks
NanoLMP: checks
*** TURN *** [Kc 2s 6h] [2c]
Veesile: bets €0.03
NanoLMP: folds
Uncalled bet (€0.03) returned to Veesile
Veesile collected €0.11 from pot
Veesile: doesn't show hand
*** SUMMARY ***
Total pot €0.12 | Rake €0.01
Board [Kc 2s 6h 2c]
Seat 1: campanilla06 (button) folded before Flop (didn't bet)
Seat 2: Veesile (small blind) collected (€0.11)
Seat 3: NanoLMP (big blind) folded on the Turn
Seat 4: Sespir folded before Flop (didn't bet)
Seat 5: ToniMarteens folded before Flop (didn't bet)
Seat 6: Luckers712 folded before Flop (didn't bet)



PokerStars Zoom Hand #210156133637:  Hold'em No Limit (€0.01/€0.02) - 2020/03/15 14:37:07 CET [2020/03/15 9:37:07 ET]
Table 'Arneb' 6-max Seat #1 is the button
Seat 1: cañon000 (€4.15 in chips)
Seat 2: Sespir (€3.24 in chips)
Seat 3: Barretone (€2 in chips)
Seat 4: Sr_Obispo (€1.98 in chips)
Seat 5: Luckers712 (€2 in chips)
Seat 6: Dark_make632 (€2.48 in chips)
Sespir: posts small blind €0.01
Barretone: posts big blind €0.02
*** HOLE CARDS ***
Dealt to Luckers712 [Ah Ac]
Sr_Obispo: folds
Luckers712: raises €0.03 to €0.05
Dark_make632: folds
cañon000: calls €0.05
Sespir: folds
Barretone: calls €0.03
*** FLOP *** [2c 3d Th]
Barretone: checks
Luckers712: checks
cañon000: checks
*** TURN *** [2c 3d Th] [2s]
Barretone: bets €0.08
Luckers712: calls €0.08
cañon000: folds
*** RIVER *** [2c 3d Th 2s] [2h]
Barretone: bets €0.12
Luckers712: raises €0.30 to €0.42
Barretone: folds
Uncalled bet (€0.30) returned to Luckers712
Luckers712 collected €0.53 from pot
Luckers712: doesn't show hand
*** SUMMARY ***
Total pot €0.56 | Rake €0.03
Board [2c 3d Th 2s 2h]
Seat 1: cañon000 (button) folded on the Turn
Seat 2: Sespir (small blind) folded before Flop
Seat 3: Barretone (big blind) folded on the River
Seat 4: Sr_Obispo folded before Flop (didn't bet)
Seat 5: Luckers712 collected (€0.53)
Seat 6: Dark_make632 folded before Flop (didn't bet)



PokerStars Zoom Hand #210156178606:  Hold'em No Limit (€0.01/€0.02) - 2020/03/15 14:38:23 CET [2020/03/15 9:38:23 ET]
Table 'Arneb' 6-max Seat #1 is the button
Seat 1: Sr_Obispo (€2.01 in chips)
Seat 2: Luckers712 (€2.28 in chips)
Seat 3: maritz12 (€2 in chips)
Seat 4: triatlon23 (€2.49 in chips)
Seat 5: Rppopy (€2 in chips)
Seat 6: Vitorhcsousa (€5.33 in chips)
Luckers712: posts small blind €0.01
maritz12: posts big blind €0.02
*** HOLE CARDS ***
Dealt to Luckers712 [Th 5c]
triatlon23: folds
Rppopy: folds
Vitorhcsousa: folds
Sr_Obispo: calls €0.02
Luckers712: folds
maritz12: checks
*** FLOP *** [6s Js 7s]
maritz12: checks
Sr_Obispo: bets €0.10
maritz12: folds
Uncalled bet (€0.10) returned to Sr_Obispo
Sr_Obispo collected €0.05 from pot
Sr_Obispo: doesn't show hand
*** SUMMARY ***
Total pot €0.05 | Rake €0
Board [6s Js 7s]
Seat 1: Sr_Obispo (button) collected (€0.05)
Seat 2: Luckers712 (small blind) folded before Flop
Seat 3: maritz12 (big blind) folded on the Flop
Seat 4: triatlon23 folded before Flop (didn't bet)
Seat 5: Rppopy folded before Flop (didn't bet)
Seat 6: Vitorhcsousa folded before Flop (didn't bet)



PokerStars Zoom Hand #210156185189:  Hold'em No Limit (€0.01/€0.02) - 2020/03/15 14:38:34 CET [2020/03/15 9:38:34 ET]
Table 'Arneb' 6-max Seat #1 is the button
Seat 1: Luckers712 (€2.25 in chips)
Seat 2: PokerStar13M (€2 in chips)
Seat 3: OSXHUM (€1.66 in chips)
Seat 4: BerCall (€3.89 in chips)
Seat 5: Sespir (€5.98 in chips)
Seat 6: raulbeni (€2.43 in chips)
PokerStar13M: posts small blind €0.01
OSXHUM: posts big blind €0.02
*** HOLE CARDS ***
Dealt to Luckers712 [Th 8d]
BerCall: folds
Sespir: folds
raulbeni: folds
Luckers712: raises €0.03 to €0.05
PokerStar13M: folds
OSXHUM: folds
Uncalled bet (€0.03) returned to Luckers712
Luckers712 collected €0.05 from pot
Luckers712: doesn't show hand
*** SUMMARY ***
Total pot €0.05 | Rake €0
Seat 1: Luckers712 (button) collected (€0.05)
Seat 2: PokerStar13M (small blind) folded before Flop
Seat 3: OSXHUM (big blind) folded before Flop
Seat 4: BerCall folded before Flop (didn't bet)
Seat 5: Sespir folded before Flop (didn't bet)
Seat 6: raulbeni folded before Flop (didn't bet)



PokerStars Zoom Hand #210156199429:  Hold'em No Limit (€0.01/€0.02) - 2020/03/15 14:38:59 CET [2020/03/15 9:38:59 ET]
Table 'Arneb' 6-max Seat #1 is the button
Seat 1: in-the-pool14 (€7.46 in chips)
Seat 2: McVieira1315 (€1.35 in chips)
Seat 3: NanoLMP (€2 in chips)
Seat 4: Bwotah (€4.08 in chips)
Seat 5: Luckers712 (€2.28 in chips)
Seat 6: RedmiPro4 (€2.07 in chips)
McVieira1315: posts small blind €0.01
NanoLMP: posts big blind €0.02
*** HOLE CARDS ***
Dealt to Luckers712 [Kh 3d]
Bwotah: raises €0.04 to €0.06
Luckers712: folds
RedmiPro4: folds
in-the-pool14: folds
McVieira1315: folds
NanoLMP: folds
Uncalled bet (€0.04) returned to Bwotah
Bwotah collected €0.05 from pot
Bwotah: doesn't show hand
*** SUMMARY ***
Total pot €0.05 | Rake €0
Seat 1: in-the-pool14 (button) folded before Flop (didn't bet)
Seat 2: McVieira1315 (small blind) folded before Flop
Seat 3: NanoLMP (big blind) folded before Flop
Seat 4: Bwotah collected (€0.05)
Seat 5: Luckers712 folded before Flop (didn't bet)
Seat 6: RedmiPro4 folded before Flop (didn't bet)



PokerStars Zoom Hand #210156197003:  Hold'em No Limit (€0.01/€0.02) - 2020/03/15 14:38:54 CET [2020/03/15 9:38:54 ET]
Table 'Arneb' 6-max Seat #1 is the button
Seat 1: riazorclub (€2.34 in chips)
Seat 2: HarmoBlues (€10.56 in chips)
Seat 3: ludena (€2 in chips)
Seat 4: BerCall (€3.89 in chips)
Seat 5: raul marguer (€4.58 in chips)
Seat 6: Luckers712 (€2.28 in chips)
HarmoBlues: posts small blind €0.01
ludena: posts big blind €0.02
*** HOLE CARDS ***
Dealt to Luckers712 [3h Jd]
BerCall: folds
raul marguer: folds
Luckers712: folds
riazorclub: folds
HarmoBlues: calls €0.01
ludena: checks
*** FLOP *** [2s Tc Ac]
HarmoBlues: checks
ludena: bets €0.02
HarmoBlues: raises €0.03 to €0.05
ludena: raises €0.03 to €0.08
HarmoBlues: calls €0.03
*** TURN *** [2s Tc Ac] [Ks]
HarmoBlues: checks
ludena: bets €0.02
HarmoBlues: raises €0.03 to €0.05
ludena: raises €0.03 to €0.08
HarmoBlues: calls €0.03
*** RIVER *** [2s Tc Ac Ks] [Kh]
HarmoBlues: checks
ludena: bets €0.18
HarmoBlues: folds
Uncalled bet (€0.18) returned to ludena
ludena collected €0.34 from pot
ludena: doesn't show hand
*** SUMMARY ***
Total pot €0.36 | Rake €0.02
Board [2s Tc Ac Ks Kh]
Seat 1: riazorclub (button) folded before Flop (didn't bet)
Seat 2: HarmoBlues (small blind) folded on the River
Seat 3: ludena (big blind) collected (€0.34)
Seat 4: BerCall folded before Flop (didn't bet)
Seat 5: raul marguer folded before Flop (didn't bet)
Seat 6: Luckers712 folded before Flop (didn't bet)



PokerStars Zoom Hand #210156204792:  Hold'em No Limit (€0.01/€0.02) - 2020/03/15 14:39:08 CET [2020/03/15 9:39:08 ET]
Table 'Arneb' 6-max Seat #1 is the button
Seat 1: JujunGele (€2.12 in chips)
Seat 2: jacksparr485 (€3.53 in chips)
Seat 3: My Udacha (€2.23 in chips)
Seat 4: Luckers712 (€2.28 in chips)
Seat 5: TheShrimp8 (€2 in chips)
Seat 6: triatlon23 (€2.60 in chips)
jacksparr485: posts small blind €0.01
My Udacha: posts big blind €0.02
*** HOLE CARDS ***
Dealt to Luckers712 [Ah 9h]
Luckers712: raises €0.04 to €0.06
TheShrimp8: folds
triatlon23: folds
JujunGele: calls €0.06
jacksparr485: folds
My Udacha: folds
*** FLOP *** [7h Tc Jh]
Luckers712: bets €0.07
JujunGele: calls €0.07
*** TURN *** [7h Tc Jh] [3s]
Luckers712: bets €0.14
JujunGele: folds
Uncalled bet (€0.14) returned to Luckers712
Luckers712 collected €0.28 from pot
Luckers712: doesn't show hand
*** SUMMARY ***
Total pot €0.29 | Rake €0.01
Board [7h Tc Jh 3s]
Seat 1: JujunGele (button) folded on the Turn
Seat 2: jacksparr485 (small blind) folded before Flop
Seat 3: My Udacha (big blind) folded before Flop
Seat 4: Luckers712 collected (€0.28)
Seat 5: TheShrimp8 folded before Flop (didn't bet)
Seat 6: triatlon23 folded before Flop (didn't bet)



PokerStars Zoom Hand #210156201865:  Hold'em No Limit (€0.01/€0.02) - 2020/03/15 14:39:03 CET [2020/03/15 9:39:03 ET]
Table 'Arneb' 6-max Seat #1 is the button
Seat 1: RSFr3ItasS_08 (€2.11 in chips)
Seat 2: unounoporfavor (€3.46 in chips)
Seat 3: BARABU1314 (€2 in chips)
Seat 4: Luckers712 (€2.28 in chips)
Seat 5: Babaa Yega (€2.35 in chips)
Seat 6: cañon000 (€4.13 in chips)
unounoporfavor: posts small blind €0.01
BARABU1314: posts big blind €0.02
*** HOLE CARDS ***
Dealt to Luckers712 [9s 8h]
Luckers712: folds
Babaa Yega: folds
cañon000: calls €0.02
RSFr3ItasS_08: folds
unounoporfavor: calls €0.01
BARABU1314: checks
*** FLOP *** [Js Jc Qd]
unounoporfavor: checks
BARABU1314: checks
cañon000: checks
*** TURN *** [Js Jc Qd] [2d]
unounoporfavor: checks
BARABU1314: checks
cañon000: checks
*** RIVER *** [Js Jc Qd 2d] [Kh]
unounoporfavor: checks
BARABU1314: checks
cañon000: checks
*** SHOW DOWN ***
unounoporfavor: shows [As 3s] (a pair of Jacks)
BARABU1314: shows [Td 2c] (two pair, Jacks and Deuces)
cañon000: mucks hand
BARABU1314 collected €0.06 from pot
*** SUMMARY ***
Total pot €0.06 | Rake €0
Board [Js Jc Qd 2d Kh]
Seat 1: RSFr3ItasS_08 (button) folded before Flop (didn't bet)
Seat 2: unounoporfavor (small blind) showed [As 3s] and lost with a pair of Jacks
Seat 3: BARABU1314 (big blind) showed [Td 2c] and won (€0.06) with two pair, Jacks and Deuces
Seat 4: Luckers712 folded before Flop (didn't bet)
Seat 5: Babaa Yega folded before Flop (didn't bet)
Seat 6: cañon000 mucked [6d 5s]



PokerStars Zoom Hand #210156234676:  Hold'em No Limit (€0.01/€0.02) - 2020/03/15 14:39:57 CET [2020/03/15 9:39:57 ET]
Table 'Arneb' 6-max Seat #1 is the button
Seat 1: willyzas (€3.89 in chips)
Seat 2: jeanba95320 (€2.30 in chips)
Seat 3: Luckers712 (€2.43 in chips)
Seat 4: RSFr3ItasS_08 (€2.08 in chips)
Seat 5: pintotuga69 (€1.82 in chips)
Seat 6: BARABU1314 (€1.93 in chips)
jeanba95320: posts small blind €0.01
Luckers712: posts big blind €0.02
*** HOLE CARDS ***
Dealt to Luckers712 [7h 7c]
RSFr3ItasS_08: folds
pintotuga69: folds
BARABU1314: folds
willyzas: folds
jeanba95320: folds
Uncalled bet (€0.01) returned to Luckers712
Luckers712 collected €0.02 from pot
Luckers712: doesn't show hand
*** SUMMARY ***
Total pot €0.02 | Rake €0
Seat 1: willyzas (button) folded before Flop (didn't bet)
Seat 2: jeanba95320 (small blind) folded before Flop
Seat 3: Luckers712 (big blind) collected (€0.02)
Seat 4: RSFr3ItasS_08 folded before Flop (didn't bet)
Seat 5: pintotuga69 folded before Flop (didn't bet)
Seat 6: BARABU1314 folded before Flop (didn't bet)



PokerStars Zoom Hand #210156181575:  Hold'em No Limit (€0.01/€0.02) - 2020/03/15 14:38:28 CET [2020/03/15 9:38:28 ET]
Table 'Arneb' 6-max Seat #1 is the button
Seat 1: fernanduelo (€1.80 in chips)
Seat 2: wilbor123 (€3.49 in chips)
Seat 3: Luckers712 (€2.27 in chips)
Seat 4: detlef (€2.01 in chips)
Seat 5: triatlon23 (€2.49 in chips)
Seat 6: Javibasket17 (€3.27 in chips)
wilbor123: posts small blind €0.01
Luckers712: posts big blind €0.02
*** HOLE CARDS ***
Dealt to Luckers712 [Kd 2h]
detlef: raises €0.04 to €0.06
triatlon23: folds
Javibasket17: folds
fernanduelo: calls €0.06
wilbor123: raises €0.20 to €0.26
Luckers712: folds
detlef: folds
fernanduelo: calls €0.20
*** FLOP *** [Ks 9s Jh]
wilbor123: checks
fernanduelo: bets €0.08
wilbor123: raises €0.37 to €0.45
fernanduelo: calls €0.37
*** TURN *** [Ks 9s Jh] [Js]
wilbor123: bets €1.42
fernanduelo: folds
Uncalled bet (€1.42) returned to wilbor123
wilbor123 collected €1.42 from pot
wilbor123: doesn't show hand
*** SUMMARY ***
Total pot €1.50 | Rake €0.08
Board [Ks 9s Jh Js]
Seat 1: fernanduelo (button) folded on the Turn
Seat 2: wilbor123 (small blind) collected (€1.42)
Seat 3: Luckers712 (big blind) folded before Flop
Seat 4: detlef folded before Flop
Seat 5: triatlon23 folded before Flop (didn't bet)
Seat 6: Javibasket17 folded before Flop (didn't bet)



PokerStars Zoom Hand #210156231765:  Hold'em No Limit (€0.01/€0.02) - 2020/03/15 14:39:52 CET [2020/03/15 9:39:52 ET]
Table 'Arneb' 6-max Seat #1 is the button
Seat 1: RaketenwolfBCN (€1.98 in chips)
Seat 2: senruedas_ (€2 in chips)
Seat 3: HeKaDeNuuK (€2 in chips)
Seat 4: Luckers712 (€2.43 in chips)
Seat 5: regpan3409 (€1.43 in chips)
Seat 6: elenagomez12 (€1.20 in chips)
senruedas_: posts small blind €0.01
HeKaDeNuuK: posts big blind €0.02
*** HOLE CARDS ***
Dealt to Luckers712 [Ac 5d]
Luckers712: folds
regpan3409: calls €0.02
elenagomez12: calls €0.02
RaketenwolfBCN: calls €0.02
senruedas_: folds
HeKaDeNuuK: checks
*** FLOP *** [Qh 9s Ks]
HeKaDeNuuK: checks
regpan3409: checks
elenagomez12: bets €0.02
RaketenwolfBCN: calls €0.02
HeKaDeNuuK: calls €0.02
regpan3409: folds
*** TURN *** [Qh 9s Ks] [2c]
HeKaDeNuuK: checks
elenagomez12: bets €0.02
RaketenwolfBCN: calls €0.02
HeKaDeNuuK: calls €0.02
*** RIVER *** [Qh 9s Ks 2c] [Ah]
HeKaDeNuuK: checks
elenagomez12: bets €0.02
RaketenwolfBCN: folds
HeKaDeNuuK: calls €0.02
*** SHOW DOWN ***
elenagomez12: shows [7s Kh] (a pair of Kings)
HeKaDeNuuK: shows [Ts Kc] (a pair of Kings - Ace+Queen+Ten kicker)
HeKaDeNuuK collected €0.24 from pot
*** SUMMARY ***
Total pot €0.25 | Rake €0.01
Board [Qh 9s Ks 2c Ah]
Seat 1: RaketenwolfBCN (button) folded on the River
Seat 2: senruedas_ (small blind) folded before Flop
Seat 3: HeKaDeNuuK (big blind) showed [Ts Kc] and won (€0.24) with a pair of Kings
Seat 4: Luckers712 folded before Flop (didn't bet)
Seat 5: regpan3409 folded on the Flop
Seat 6: elenagomez12 showed [7s Kh] and lost with a pair of Kings



PokerStars Zoom Hand #210156239991:  Hold'em No Limit (€0.01/€0.02) - 2020/03/15 14:40:06 CET [2020/03/15 9:40:06 ET]
Table 'Arneb' 6-max Seat #1 is the button
Seat 1: JujunGele (€2.02 in chips)
Seat 2: Luckers712 (€2.44 in chips)
Seat 3: FreudMind (€2 in chips)
Seat 4: jacksparr485 (€4.16 in chips)
Seat 5: Comlan22 (€2 in chips)
Seat 6: RedmiPro4 (€2.38 in chips)
Luckers712: posts small blind €0.01
FreudMind: posts big blind €0.02
*** HOLE CARDS ***
Dealt to Luckers712 [Kd As]
jacksparr485: folds
Comlan22: folds
RedmiPro4: folds
JujunGele: raises €0.04 to €0.06
Luckers712: raises €0.14 to €0.20
FreudMind: folds
JujunGele: calls €0.14
*** FLOP *** [6c 9h 2c]
Luckers712: checks
JujunGele: checks
*** TURN *** [6c 9h 2c] [3c]
Luckers712: checks
JujunGele: checks
*** RIVER *** [6c 9h 2c 3c] [5d]
Luckers712: checks
JujunGele: checks
*** SHOW DOWN ***
Luckers712: shows [Kd As] (high card Ace)
JujunGele: mucks hand
Luckers712 collected €0.40 from pot
*** SUMMARY ***
Total pot €0.42 | Rake €0.02
Board [6c 9h 2c 3c 5d]
Seat 1: JujunGele (button) mucked [Th Qh]
Seat 2: Luckers712 (small blind) showed [Kd As] and won (€0.40) with high card Ace
Seat 3: FreudMind (big blind) folded before Flop
Seat 4: jacksparr485 folded before Flop (didn't bet)
Seat 5: Comlan22 folded before Flop (didn't bet)
Seat 6: RedmiPro4 folded before Flop (didn't bet)



PokerStars Zoom Hand #210156285861:  Hold'em No Limit (€0.01/€0.02) - 2020/03/15 14:41:23 CET [2020/03/15 9:41:23 ET]
Table 'Arneb' 6-max Seat #1 is the button
Seat 1: Luckers712 (€2.64 in chips)
Seat 2: JujunGele (€1.82 in chips)
Seat 3: chiwas12 (€6.31 in chips)
Seat 4: NanoLMP (€2.74 in chips)
Seat 5: willyzas (€3.89 in chips)
Seat 6: jeanba95320 (€2 in chips)
JujunGele: posts small blind €0.01
chiwas12: posts big blind €0.02
*** HOLE CARDS ***
Dealt to Luckers712 [Th 6c]
NanoLMP: folds
willyzas has timed out
willyzas: folds
jeanba95320: folds
Luckers712: folds
JujunGele: folds
Uncalled bet (€0.01) returned to chiwas12
chiwas12 collected €0.02 from pot
chiwas12: doesn't show hand
*** SUMMARY ***
Total pot €0.02 | Rake €0
Seat 1: Luckers712 (button) folded before Flop (didn't bet)
Seat 2: JujunGele (small blind) folded before Flop
Seat 3: chiwas12 (big blind) collected (€0.02)
Seat 4: NanoLMP folded before Flop (didn't bet)
Seat 5: willyzas folded before Flop (didn't bet)
Seat 6: jeanba95320 folded before Flop (didn't bet)



PokerStars Zoom Hand #210156291874:  Hold'em No Limit (€0.01/€0.02) - 2020/03/15 14:41:33 CET [2020/03/15 9:41:33 ET]
Table 'Arneb' 6-max Seat #1 is the button
Seat 1: Veesile (€2.26 in chips)
Seat 2: Juanfalco98 (€2.05 in chips)
Seat 3: Luckers712 (€2.64 in chips)
Seat 4: tag44399 (€5.33 in chips)
Seat 5: BARABU1314 (€1.99 in chips)
Seat 6: JOHNNYDU42 (€2.83 in chips)
Juanfalco98: posts small blind €0.01
Luckers712: posts big blind €0.02
*** HOLE CARDS ***
Dealt to Luckers712 [As 5s]
tag44399: folds
BARABU1314: folds
JOHNNYDU42: folds
Veesile: folds
Juanfalco98: raises €0.04 to €0.06
Luckers712: calls €0.04
*** FLOP *** [2d Tc Js]
Juanfalco98: bets €0.04
Luckers712: calls €0.04
*** TURN *** [2d Tc Js] [Qd]
Juanfalco98: bets €0.14
Luckers712: folds
Uncalled bet (€0.14) returned to Juanfalco98
Juanfalco98 collected €0.19 from pot
Juanfalco98: doesn't show hand
*** SUMMARY ***
Total pot €0.20 | Rake €0.01
Board [2d Tc Js Qd]
Seat 1: Veesile (button) folded before Flop (didn't bet)
Seat 2: Juanfalco98 (small blind) collected (€0.19)
Seat 3: Luckers712 (big blind) folded on the Turn
Seat 4: tag44399 folded before Flop (didn't bet)
Seat 5: BARABU1314 folded before Flop (didn't bet)
Seat 6: JOHNNYDU42 folded before Flop (didn't bet)



PokerStars Zoom Hand #210156289493:  Hold'em No Limit (€0.01/€0.02) - 2020/03/15 14:41:29 CET [2020/03/15 9:41:29 ET]
Table 'Arneb' 6-max Seat #1 is the button
Seat 1: payoviejo (€2 in chips)
Seat 2: Barretone (€2.12 in chips)
Seat 3: R. Quilez r. (€2 in chips)
Seat 4: Luckers712 (€2.64 in chips)
Seat 5: PakasLE (€3.31 in chips)
Seat 6: Dark_make632 (€2.25 in chips)
Barretone: posts small blind €0.01
R. Quilez r.: posts big blind €0.02
*** HOLE CARDS ***
Dealt to Luckers712 [6s 7d]
Luckers712: folds
PakasLE: folds
Dark_make632: folds
payoviejo: folds
Barretone: calls €0.01
R. Quilez r.: checks
*** FLOP *** [Kc 2h 4h]
Barretone: checks
R. Quilez r.: checks
*** TURN *** [Kc 2h 4h] [As]
Barretone: checks
R. Quilez r.: bets €0.02
Barretone: raises €0.08 to €0.10
R. Quilez r.: calls €0.08
*** RIVER *** [Kc 2h 4h As] [Qh]
Barretone: checks
R. Quilez r.: bets €0.12
Barretone: folds
Uncalled bet (€0.12) returned to R. Quilez r.
R. Quilez r. collected €0.23 from pot
R. Quilez r.: doesn't show hand
*** SUMMARY ***
Total pot €0.24 | Rake €0.01
Board [Kc 2h 4h As Qh]
Seat 1: payoviejo (button) folded before Flop (didn't bet)
Seat 2: Barretone (small blind) folded on the River
Seat 3: R. Quilez r. (big blind) collected (€0.23)
Seat 4: Luckers712 folded before Flop (didn't bet)
Seat 5: PakasLE folded before Flop (didn't bet)
Seat 6: Dark_make632 folded before Flop (didn't bet)



PokerStars Zoom Hand #210156315000:  Hold'em No Limit (€0.01/€0.02) - 2020/03/15 14:42:12 CET [2020/03/15 9:42:12 ET]
Table 'Arneb' 6-max Seat #1 is the button
Seat 1: My Udacha (€4.65 in chips)
Seat 2: Raquel_Dourado (€1.01 in chips)
Seat 3: HarmoBlues (€10.55 in chips)
Seat 4: Redbox615 (€2.26 in chips)
Seat 5: ekzemaker (€4.93 in chips)
Seat 6: Luckers712 (€2.54 in chips)
Raquel_Dourado: posts small blind €0.01
HarmoBlues: posts big blind €0.02
*** HOLE CARDS ***
Dealt to Luckers712 [Ac 9d]
Redbox615: folds
ekzemaker: folds
Luckers712: raises €0.03 to €0.05
My Udacha: folds
Raquel_Dourado: folds
HarmoBlues: folds
Uncalled bet (€0.03) returned to Luckers712
Luckers712 collected €0.05 from pot
Luckers712: doesn't show hand
*** SUMMARY ***
Total pot €0.05 | Rake €0
Seat 1: My Udacha (button) folded before Flop (didn't bet)
Seat 2: Raquel_Dourado (small blind) folded before Flop
Seat 3: HarmoBlues (big blind) folded before Flop
Seat 4: Redbox615 folded before Flop (didn't bet)
Seat 5: ekzemaker folded before Flop (didn't bet)
Seat 6: Luckers712 collected (€0.05)



PokerStars Zoom Hand #210156322839:  Hold'em No Limit (€0.01/€0.02) - 2020/03/15 14:42:25 CET [2020/03/15 9:42:25 ET]
Table 'Arneb' 6-max Seat #1 is the button
Seat 1: BARABU1314 (€1.94 in chips)
Seat 2: Luckers712 (€2.57 in chips)
Seat 3: MasterOfPuppet5 (€1 in chips)
Seat 4: willyzas (€4.23 in chips)
Seat 5: pabmesa (€2.46 in chips)
Seat 6: campanilla06 (€2.24 in chips)
Luckers712: posts small blind €0.01
MasterOfPuppet5: posts big blind €0.02
*** HOLE CARDS ***
Dealt to Luckers712 [3c 5d]
willyzas: folds
pabmesa: folds
campanilla06: folds
BARABU1314: raises €0.02 to €0.04
Luckers712: folds
MasterOfPuppet5: folds
Uncalled bet (€0.02) returned to BARABU1314
BARABU1314 collected €0.05 from pot
BARABU1314: doesn't show hand
*** SUMMARY ***
Total pot €0.05 | Rake €0
Seat 1: BARABU1314 (button) collected (€0.05)
Seat 2: Luckers712 (small blind) folded before Flop
Seat 3: MasterOfPuppet5 (big blind) folded before Flop
Seat 4: willyzas folded before Flop (didn't bet)
Seat 5: pabmesa folded before Flop (didn't bet)
Seat 6: campanilla06 folded before Flop (didn't bet)



PokerStars Zoom Hand #210156325780:  Hold'em No Limit (€0.01/€0.02) - 2020/03/15 14:42:31 CET [2020/03/15 9:42:31 ET]
Table 'Arneb' 6-max Seat #1 is the button
Seat 1: Luckers712 (€2.56 in chips)
Seat 2: RSFr3ItasS_08 (€2.25 in chips)
Seat 3: triatlon23 (€2.04 in chips)
Seat 4: TheShrimp8 (€2.03 in chips)
Seat 5: JujunGele (€1.01 in chips)
Seat 6: in-the-pool14 (€2.78 in chips)
RSFr3ItasS_08: posts small blind €0.01
triatlon23: posts big blind €0.02
*** HOLE CARDS ***
Dealt to Luckers712 [9h 6d]
TheShrimp8: folds
JujunGele: raises €0.04 to €0.06
in-the-pool14: folds
Luckers712: folds
RSFr3ItasS_08: folds
triatlon23: folds
Uncalled bet (€0.04) returned to JujunGele
JujunGele collected €0.05 from pot
JujunGele: doesn't show hand
*** SUMMARY ***
Total pot €0.05 | Rake €0
Seat 1: Luckers712 (button) folded before Flop (didn't bet)
Seat 2: RSFr3ItasS_08 (small blind) folded before Flop
Seat 3: triatlon23 (big blind) folded before Flop
Seat 4: TheShrimp8 folded before Flop (didn't bet)
Seat 5: JujunGele collected (€0.05)
Seat 6: in-the-pool14 folded before Flop (didn't bet)



PokerStars Zoom Hand #210156338890:  Hold'em No Limit (€0.01/€0.02) - 2020/03/15 14:42:53 CET [2020/03/15 9:42:53 ET]
Table 'Arneb' 6-max Seat #1 is the button
Seat 1: Luckers712 (€2.56 in chips)
Seat 2: Jesuscb88 (€1.47 in chips)
Seat 3: FreudMind (€2 in chips)
Seat 4: chiwas12 (€6.36 in chips)
Seat 5: Redbox615 (€2.25 in chips)
Seat 6: RSFr3ItasS_08 (€3.30 in chips)
Jesuscb88: posts small blind €0.01
FreudMind: posts big blind €0.02
*** HOLE CARDS ***
Dealt to Luckers712 [5d 2c]
chiwas12: folds
Redbox615: folds
RSFr3ItasS_08: folds
Luckers712: folds
Jesuscb88: folds
Uncalled bet (€0.01) returned to FreudMind
FreudMind collected €0.02 from pot
FreudMind: doesn't show hand
*** SUMMARY ***
Total pot €0.02 | Rake €0
Seat 1: Luckers712 (button) folded before Flop (didn't bet)
Seat 2: Jesuscb88 (small blind) folded before Flop
Seat 3: FreudMind (big blind) collected (€0.02)
Seat 4: chiwas12 folded before Flop (didn't bet)
Seat 5: Redbox615 folded before Flop (didn't bet)
Seat 6: RSFr3ItasS_08 folded before Flop (didn't bet)



PokerStars Zoom Hand #210156333386:  Hold'em No Limit (€0.01/€0.02) - 2020/03/15 14:42:43 CET [2020/03/15 9:42:43 ET]
Table 'Arneb' 6-max Seat #1 is the button
Seat 1: 11.M.R.K.11 (€2 in chips)
Seat 2: detlef (€2 in chips)
Seat 3: chiwas12 (€7.16 in chips)
Seat 4: NanoLMP (€2.79 in chips)
Seat 5: Luckers712 (€2.56 in chips)
Seat 6: m.martines (€2.48 in chips)
detlef: posts small blind €0.01
chiwas12: posts big blind €0.02
*** HOLE CARDS ***
Dealt to Luckers712 [7s Th]
NanoLMP: folds
Luckers712: folds
m.martines: folds
11.M.R.K.11 has timed out
11.M.R.K.11: folds
detlef: folds
Uncalled bet (€0.01) returned to chiwas12
chiwas12 collected €0.02 from pot
chiwas12: doesn't show hand
*** SUMMARY ***
Total pot €0.02 | Rake €0
Seat 1: 11.M.R.K.11 (button) folded before Flop (didn't bet)
Seat 2: detlef (small blind) folded before Flop
Seat 3: chiwas12 (big blind) collected (€0.02)
Seat 4: NanoLMP folded before Flop (didn't bet)
Seat 5: Luckers712 folded before Flop (didn't bet)
Seat 6: m.martines folded before Flop (didn't bet)



PokerStars Zoom Hand #210156330487:  Hold'em No Limit (€0.01/€0.02) - 2020/03/15 14:42:38 CET [2020/03/15 9:42:38 ET]
Table 'Arneb' 6-max Seat #1 is the button
Seat 1: j om13015 (€1.83 in chips)
Seat 2: R. Quilez r. (€2.14 in chips)
Seat 3: Dark_make632 (€2.19 in chips)
Seat 4: Babaa Yega (€2.34 in chips)
Seat 5: riazorclub (€1.57 in chips)
Seat 6: Luckers712 (€2.56 in chips)
R. Quilez r.: posts small blind €0.01
Dark_make632: posts big blind €0.02
*** HOLE CARDS ***
Dealt to Luckers712 [5h Jh]
Babaa Yega: folds
riazorclub: folds
Luckers712: folds
j om13015: calls €0.02
R. Quilez r.: folds
Dark_make632: checks
*** FLOP *** [4c 3h 5d]
Dark_make632: checks
j om13015: checks
*** TURN *** [4c 3h 5d] [8c]
Dark_make632: bets €0.03
j om13015: folds
Uncalled bet (€0.03) returned to Dark_make632
Dark_make632 collected €0.05 from pot
Dark_make632: doesn't show hand
*** SUMMARY ***
Total pot €0.05 | Rake €0
Board [4c 3h 5d 8c]
Seat 1: j om13015 (button) folded on the Turn
Seat 2: R. Quilez r. (small blind) folded before Flop
Seat 3: Dark_make632 (big blind) collected (€0.05)
Seat 4: Babaa Yega folded before Flop (didn't bet)
Seat 5: riazorclub folded before Flop (didn't bet)
Seat 6: Luckers712 folded before Flop (didn't bet)



PokerStars Zoom Hand #210156341251:  Hold'em No Limit (€0.01/€0.02) - 2020/03/15 14:42:56 CET [2020/03/15 9:42:56 ET]
Table 'Arneb' 6-max Seat #1 is the button
Seat 1: rikardnho5 (€4.15 in chips)
Seat 2: riazorclub (€3.89 in chips)
Seat 3: Luckers712 (€2.56 in chips)
Seat 4: ngotiz (€2.54 in chips)
Seat 5: leobcn9 (€3.13 in chips)
Seat 6: Bwotah (€4.79 in chips)
riazorclub: posts small blind €0.01
Luckers712: posts big blind €0.02
*** HOLE CARDS ***
Dealt to Luckers712 [9s 3h]
ngotiz: folds
leobcn9: raises €0.04 to €0.06
Bwotah: folds
rikardnho5: folds
riazorclub: calls €0.05
Luckers712: folds
*** FLOP *** [7c 8h 7s]
riazorclub: checks
leobcn9: checks
*** TURN *** [7c 8h 7s] [Qs]
riazorclub: checks
leobcn9: bets €0.08
riazorclub: folds
Uncalled bet (€0.08) returned to leobcn9
leobcn9 collected €0.13 from pot
leobcn9: doesn't show hand
*** SUMMARY ***
Total pot €0.14 | Rake €0.01
Board [7c 8h 7s Qs]
Seat 1: rikardnho5 (button) folded before Flop (didn't bet)
Seat 2: riazorclub (small blind) folded on the Turn
Seat 3: Luckers712 (big blind) folded before Flop
Seat 4: ngotiz folded before Flop (didn't bet)
Seat 5: leobcn9 collected (€0.13)
Seat 6: Bwotah folded before Flop (didn't bet)



PokerStars Zoom Hand #210156336440:  Hold'em No Limit (€0.01/€0.02) - 2020/03/15 14:42:48 CET [2020/03/15 9:42:48 ET]
Table 'Arneb' 6-max Seat #1 is the button
Seat 1: Ozzyuru_9 (€2.84 in chips)
Seat 2: willyzas (€3.96 in chips)
Seat 3: riazorclub (€1.57 in chips)
Seat 4: McVieira1315 (€1.28 in chips)
Seat 5: Luckers712 (€2.56 in chips)
Seat 6: anyiinca (€3.09 in chips)
willyzas: posts small blind €0.01
riazorclub: posts big blind €0.02
*** HOLE CARDS ***
Dealt to Luckers712 [8s 7c]
McVieira1315: folds
Luckers712: folds
anyiinca has timed out
anyiinca: folds
Ozzyuru_9: raises €0.04 to €0.06
willyzas: folds
riazorclub: calls €0.04
*** FLOP *** [Qc 3s 8h]
riazorclub: checks
Ozzyuru_9: checks
*** TURN *** [Qc 3s 8h] [Kc]
riazorclub: bets €0.08
Ozzyuru_9: folds
Uncalled bet (€0.08) returned to riazorclub
riazorclub collected €0.12 from pot
riazorclub: doesn't show hand
*** SUMMARY ***
Total pot €0.13 | Rake €0.01
Board [Qc 3s 8h Kc]
Seat 1: Ozzyuru_9 (button) folded on the Turn
Seat 2: willyzas (small blind) folded before Flop
Seat 3: riazorclub (big blind) collected (€0.12)
Seat 4: McVieira1315 folded before Flop (didn't bet)
Seat 5: Luckers712 folded before Flop (didn't bet)
Seat 6: anyiinca folded before Flop (didn't bet)



PokerStars Zoom Hand #210156345353:  Hold'em No Limit (€0.01/€0.02) - 2020/03/15 14:43:03 CET [2020/03/15 9:43:03 ET]
Table 'Arneb' 6-max Seat #1 is the button
Seat 1: RSFr3ItasS_08 (€3.29 in chips)
Seat 2: Luckers712 (€2.54 in chips)
Seat 3: tag44399 (€0.64 in chips)
Seat 4: TheShrimp8 (€2.48 in chips)
Seat 5: chiwas12 (€7.17 in chips)
Seat 6: Dark_make632 (€2.18 in chips)
Luckers712: posts small blind €0.01
tag44399: posts big blind €0.02
*** HOLE CARDS ***
Dealt to Luckers712 [6d 4d]
TheShrimp8: folds
chiwas12: folds
Dark_make632: folds
RSFr3ItasS_08: raises €0.04 to €0.06
Luckers712: raises €0.18 to €0.24
tag44399: folds
RSFr3ItasS_08: calls €0.18
*** FLOP *** [5d 5c 6s]
Luckers712: bets €0.14
RSFr3ItasS_08: calls €0.14
*** TURN *** [5d 5c 6s] [5s]
Luckers712: checks
RSFr3ItasS_08: checks
*** RIVER *** [5d 5c 6s 5s] [Jc]
Luckers712: checks
RSFr3ItasS_08: checks
*** SHOW DOWN ***
Luckers712: shows [6d 4d] (a full house, Fives full of Sixes)
RSFr3ItasS_08: mucks hand
Luckers712 collected €0.74 from pot
*** SUMMARY ***
Total pot €0.78 | Rake €0.04
Board [5d 5c 6s 5s Jc]
Seat 1: RSFr3ItasS_08 (button) mucked [Ac Kc]
Seat 2: Luckers712 (small blind) showed [6d 4d] and won (€0.74) with a full house, Fives full of Sixes
Seat 3: tag44399 (big blind) folded before Flop
Seat 4: TheShrimp8 folded before Flop (didn't bet)
Seat 5: chiwas12 folded before Flop (didn't bet)
Seat 6: Dark_make632 folded before Flop (didn't bet)



PokerStars Zoom Hand #210156384958:  Hold'em No Limit (€0.01/€0.02) - 2020/03/15 14:44:10 CET [2020/03/15 9:44:10 ET]
Table 'Arneb' 6-max Seat #1 is the button
Seat 1: djoelix173 (€1.91 in chips)
Seat 2: maritz12 (€3.96 in chips)
Seat 3: Rppopy (€3.60 in chips)
Seat 4: Luckers712 (€2.90 in chips)
Seat 5: Dark_make632 (€2.23 in chips)
Seat 6: PakasLE (€3.31 in chips)
maritz12: posts small blind €0.01
Rppopy: posts big blind €0.02
*** HOLE CARDS ***
Dealt to Luckers712 [Kc Qh]
Luckers712: raises €0.03 to €0.05
Dark_make632: folds
PakasLE: calls €0.05
djoelix173: folds
maritz12: folds
Rppopy: folds
*** FLOP *** [Th 2c 8s]
Luckers712: checks
PakasLE: checks
*** TURN *** [Th 2c 8s] [2d]
Luckers712: checks
PakasLE: checks
*** RIVER *** [Th 2c 8s 2d] [3c]
Luckers712: checks
PakasLE: checks
*** SHOW DOWN ***
Luckers712: shows [Kc Qh] (a pair of Deuces)
PakasLE: shows [9c As] (a pair of Deuces - Ace kicker)
PakasLE collected €0.12 from pot
*** SUMMARY ***
Total pot €0.13 | Rake €0.01
Board [Th 2c 8s 2d 3c]
Seat 1: djoelix173 (button) folded before Flop (didn't bet)
Seat 2: maritz12 (small blind) folded before Flop
Seat 3: Rppopy (big blind) folded before Flop
Seat 4: Luckers712 showed [Kc Qh] and lost with a pair of Deuces
Seat 5: Dark_make632 folded before Flop (didn't bet)
Seat 6: PakasLE showed [9c As] and won (€0.12) with a pair of Deuces



PokerStars Zoom Hand #210156409498:  Hold'em No Limit (€0.01/€0.02) - 2020/03/15 14:44:51 CET [2020/03/15 9:44:51 ET]
Table 'Arneb' 6-max Seat #1 is the button
Seat 1: m.martines (€2.27 in chips)
Seat 2: Sespir (€2.53 in chips)
Seat 3: Mr MMKING (€1.83 in chips)
Seat 4: Luckers712 (€2.85 in chips)
Seat 5: tag44399 (€5.72 in chips)
Seat 6: eD_brump (€2.10 in chips)
Sespir: posts small blind €0.01
Mr MMKING: posts big blind €0.02
*** HOLE CARDS ***
Dealt to Luckers712 [3c 9h]
Luckers712: folds
tag44399: raises €0.04 to €0.06
eD_brump: folds
m.martines: folds
Sespir: folds
Mr MMKING: folds
Uncalled bet (€0.04) returned to tag44399
tag44399 collected €0.05 from pot
tag44399: doesn't show hand
*** SUMMARY ***
Total pot €0.05 | Rake €0
Seat 1: m.martines (button) folded before Flop (didn't bet)
Seat 2: Sespir (small blind) folded before Flop
Seat 3: Mr MMKING (big blind) folded before Flop
Seat 4: Luckers712 folded before Flop (didn't bet)
Seat 5: tag44399 collected (€0.05)
Seat 6: eD_brump folded before Flop (didn't bet)



PokerStars Zoom Hand #210156411876:  Hold'em No Limit (€0.01/€0.02) - 2020/03/15 14:44:54 CET [2020/03/15 9:44:54 ET]
Table 'Arneb' 6-max Seat #1 is the button
Seat 1: tag44399 (€2.72 in chips)
Seat 2: Luckers712 (€2.85 in chips)
Seat 3: HeKaDeNuuK (€2.31 in chips)
Seat 4: taysson9 (€2.03 in chips)
Seat 5: Dark_make632 (€2.21 in chips)
Seat 6: jbrancobl (€2.23 in chips)
Luckers712: posts small blind €0.01
HeKaDeNuuK: posts big blind €0.02
*** HOLE CARDS ***
Dealt to Luckers712 [9d 7s]
taysson9: folds
Dark_make632: folds
jbrancobl: folds
tag44399: folds
Luckers712: folds
Uncalled bet (€0.01) returned to HeKaDeNuuK
HeKaDeNuuK collected €0.02 from pot
HeKaDeNuuK: doesn't show hand
*** SUMMARY ***
Total pot €0.02 | Rake €0
Seat 1: tag44399 (button) folded before Flop (didn't bet)
Seat 2: Luckers712 (small blind) folded before Flop
Seat 3: HeKaDeNuuK (big blind) collected (€0.02)
Seat 4: taysson9 folded before Flop (didn't bet)
Seat 5: Dark_make632 folded before Flop (didn't bet)
Seat 6: jbrancobl folded before Flop (didn't bet)



PokerStars Zoom Hand #210156414004:  Hold'em No Limit (€0.01/€0.02) - 2020/03/15 14:44:58 CET [2020/03/15 9:44:58 ET]
Table 'Arneb' 6-max Seat #1 is the button
Seat 1: Juanfalco98 (€1.98 in chips)
Seat 2: unounoporfavor (€3.52 in chips)
Seat 3: Sespir (€3.39 in chips)
Seat 4: ToniMarteens (€0.88 in chips)
Seat 5: crysber (€2.45 in chips)
Seat 6: Luckers712 (€2.84 in chips)
unounoporfavor: posts small blind €0.01
Sespir: posts big blind €0.02
*** HOLE CARDS ***
Dealt to Luckers712 [Qd Ad]
ToniMarteens: folds
crysber: calls €0.02
Luckers712: calls €0.02
Juanfalco98: folds
unounoporfavor: calls €0.01
Sespir: checks
*** FLOP *** [8s 9d 4h]
unounoporfavor: checks
Sespir: checks
crysber: bets €0.08
Luckers712: calls €0.08
unounoporfavor: folds
Sespir: raises €0.20 to €0.28
crysber: folds
Luckers712: folds
Uncalled bet (€0.20) returned to Sespir
Sespir collected €0.30 from pot
*** SUMMARY ***
Total pot €0.32 | Rake €0.02
Board [8s 9d 4h]
Seat 1: Juanfalco98 (button) folded before Flop (didn't bet)
Seat 2: unounoporfavor (small blind) folded on the Flop
Seat 3: Sespir (big blind) collected (€0.30)
Seat 4: ToniMarteens folded before Flop (didn't bet)
Seat 5: crysber folded on the Flop
Seat 6: Luckers712 folded on the Flop



PokerStars Zoom Hand #210156457602:  Hold'em No Limit (€0.01/€0.02) - 2020/03/15 14:46:11 CET [2020/03/15 9:46:11 ET]
Table 'Arneb' 6-max Seat #1 is the button
Seat 1: PokerStar13M (€2.03 in chips)
Seat 2: MasterOfPuppet5 (€0.86 in chips)
Seat 3: Luckers712 (€2.74 in chips)
Seat 4: Rppopy (€2 in chips)
Seat 5: eD_brump (€2.32 in chips)
Seat 6: NanoLMP (€2.62 in chips)
MasterOfPuppet5: posts small blind €0.01
Luckers712: posts big blind €0.02
*** HOLE CARDS ***
Dealt to Luckers712 [6s Ts]
Rppopy: folds
eD_brump: folds
NanoLMP: folds
PokerStar13M: folds
MasterOfPuppet5: raises €0.02 to €0.04
Luckers712: calls €0.02
*** FLOP *** [9s Kc Th]
MasterOfPuppet5: checks
Luckers712: bets €0.04
MasterOfPuppet5: folds
Uncalled bet (€0.04) returned to Luckers712
Luckers712 collected €0.08 from pot
Luckers712: doesn't show hand
*** SUMMARY ***
Total pot €0.08 | Rake €0
Board [9s Kc Th]
Seat 1: PokerStar13M (button) folded before Flop (didn't bet)
Seat 2: MasterOfPuppet5 (small blind) folded on the Flop
Seat 3: Luckers712 (big blind) collected (€0.08)
Seat 4: Rppopy folded before Flop (didn't bet)
Seat 5: eD_brump folded before Flop (didn't bet)
Seat 6: NanoLMP folded before Flop (didn't bet)



PokerStars Zoom Hand #210156470734:  Hold'em No Limit (€0.01/€0.02) - 2020/03/15 14:46:34 CET [2020/03/15 9:46:34 ET]
Table 'Arneb' 6-max Seat #1 is the button
Seat 1: Luckers712 (€2.78 in chips)
Seat 2: PokerStar13M (€2.04 in chips)
Seat 3: Bwotah (€5.98 in chips)
Seat 4: juuanito128 (€3.10 in chips)
Seat 5: Dark_make632 (€2.47 in chips)
Seat 6: melodie81 (€1.03 in chips)
PokerStar13M: posts small blind €0.01
Bwotah: posts big blind €0.02
*** HOLE CARDS ***
Dealt to Luckers712 [Ts Kc]
juuanito128: folds
Dark_make632: folds
melodie81: folds
Luckers712: raises €0.03 to €0.05
PokerStar13M: folds
Bwotah: folds
Uncalled bet (€0.03) returned to Luckers712
Luckers712 collected €0.05 from pot
Luckers712: doesn't show hand
*** SUMMARY ***
Total pot €0.05 | Rake €0
Seat 1: Luckers712 (button) collected (€0.05)
Seat 2: PokerStar13M (small blind) folded before Flop
Seat 3: Bwotah (big blind) folded before Flop
Seat 4: juuanito128 folded before Flop (didn't bet)
Seat 5: Dark_make632 folded before Flop (didn't bet)
Seat 6: melodie81 folded before Flop (didn't bet)



PokerStars Zoom Hand #210156482289:  Hold'em No Limit (€0.01/€0.02) - 2020/03/15 14:46:53 CET [2020/03/15 9:46:53 ET]
Table 'Arneb' 6-max Seat #1 is the button
Seat 1: OSXHUM (€1.69 in chips)
Seat 2: saulb16 (€1.49 in chips)
Seat 3: PakasLE (€3.39 in chips)
Seat 4: NanoLMP (€2.76 in chips)
Seat 5: Ozzyuru_9 (€1.98 in chips)
Seat 6: Luckers712 (€2.81 in chips)
saulb16: posts small blind €0.01
PakasLE: posts big blind €0.02
*** HOLE CARDS ***
Dealt to Luckers712 [7h 7c]
NanoLMP: folds
Ozzyuru_9: folds
Luckers712: raises €0.03 to €0.05
OSXHUM: folds
saulb16: folds
PakasLE: folds
Uncalled bet (€0.03) returned to Luckers712
Luckers712 collected €0.05 from pot
Luckers712: doesn't show hand
*** SUMMARY ***
Total pot €0.05 | Rake €0
Seat 1: OSXHUM (button) folded before Flop (didn't bet)
Seat 2: saulb16 (small blind) folded before Flop
Seat 3: PakasLE (big blind) folded before Flop
Seat 4: NanoLMP folded before Flop (didn't bet)
Seat 5: Ozzyuru_9 folded before Flop (didn't bet)
Seat 6: Luckers712 collected (€0.05)



PokerStars Zoom Hand #210156491354:  Hold'em No Limit (€0.01/€0.02) - 2020/03/15 14:47:08 CET [2020/03/15 9:47:08 ET]
Table 'Arneb' 6-max Seat #1 is the button
Seat 1: melodie81 (€1.07 in chips)
Seat 2: Veesile (€2.01 in chips)
Seat 3: Pocas Prisas (€2.42 in chips)
Seat 4: DNooXLvv (€8.31 in chips)
Seat 5: Luckers712 (€2.84 in chips)
Seat 6: passinha_scp (€1.20 in chips)
Veesile: posts small blind €0.01
Pocas Prisas: posts big blind €0.02
*** HOLE CARDS ***
Dealt to Luckers712 [3c Th]
DNooXLvv: folds
Luckers712: folds
passinha_scp: raises €0.04 to €0.06
melodie81: folds
Veesile: folds
Pocas Prisas: calls €0.04
*** FLOP *** [8s 6c Ks]
Pocas Prisas: checks
passinha_scp: bets €0.04
Pocas Prisas: folds
Uncalled bet (€0.04) returned to passinha_scp
passinha_scp collected €0.12 from pot
passinha_scp: doesn't show hand
*** SUMMARY ***
Total pot €0.13 | Rake €0.01
Board [8s 6c Ks]
Seat 1: melodie81 (button) folded before Flop (didn't bet)
Seat 2: Veesile (small blind) folded before Flop
Seat 3: Pocas Prisas (big blind) folded on the Flop
Seat 4: DNooXLvv folded before Flop (didn't bet)
Seat 5: Luckers712 folded before Flop (didn't bet)
Seat 6: passinha_scp collected (€0.12)



PokerStars Zoom Hand #210156494305:  Hold'em No Limit (€0.01/€0.02) - 2020/03/15 14:47:13 CET [2020/03/15 9:47:13 ET]
Table 'Arneb' 6-max Seat #1 is the button
Seat 1: bulose345 (€1 in chips)
Seat 2: riazorclub (€1.92 in chips)
Seat 3: DLA6 (€1.56 in chips)
Seat 4: Luckers712 (€2.84 in chips)
Seat 5: lochpo71 (€2 in chips)
Seat 6: Juanfalco98 (€2.09 in chips)
riazorclub: posts small blind €0.01
DLA6: posts big blind €0.02
*** HOLE CARDS ***
Dealt to Luckers712 [Ac Jd]
Luckers712: raises €0.03 to €0.05
lochpo71: folds
Juanfalco98: folds
bulose345: raises €0.13 to €0.18
riazorclub: folds
DLA6: folds
Luckers712: calls €0.13
*** FLOP *** [2s 7d 3s]
Luckers712: checks
bulose345: bets €0.18
Luckers712: folds
Uncalled bet (€0.18) returned to bulose345
bulose345 collected €0.37 from pot
*** SUMMARY ***
Total pot €0.39 | Rake €0.02
Board [2s 7d 3s]
Seat 1: bulose345 (button) collected (€0.37)
Seat 2: riazorclub (small blind) folded before Flop
Seat 3: DLA6 (big blind) folded before Flop
Seat 4: Luckers712 folded on the Flop
Seat 5: lochpo71 folded before Flop (didn't bet)
Seat 6: Juanfalco98 folded before Flop (didn't bet)



PokerStars Zoom Hand #210156488939:  Hold'em No Limit (€0.01/€0.02) - 2020/03/15 14:47:04 CET [2020/03/15 9:47:04 ET]
Table 'Arneb' 6-max Seat #1 is the button
Seat 1: Zé Zé Sete (€1.61 in chips)
Seat 2: raul marguer (€4.56 in chips)
Seat 3: amanso (€2.36 in chips)
Seat 4: tag44399 (€1.15 in chips)
Seat 5: Luckers712 (€2.84 in chips)
Seat 6: chiwas12 (€9.54 in chips)
raul marguer: posts small blind €0.01
amanso: posts big blind €0.02
*** HOLE CARDS ***
Dealt to Luckers712 [7c Ks]
tag44399: folds
Luckers712: folds
chiwas12: folds
Zé Zé Sete: folds
raul marguer: calls €0.01
amanso: checks
*** FLOP *** [9s Kc Kh]
raul marguer: checks
amanso: checks
*** TURN *** [9s Kc Kh] [8s]
raul marguer: checks
amanso: bets €0.04
raul marguer: folds
Uncalled bet (€0.04) returned to amanso
amanso collected €0.04 from pot
amanso: doesn't show hand
*** SUMMARY ***
Total pot €0.04 | Rake €0
Board [9s Kc Kh 8s]
Seat 1: Zé Zé Sete (button) folded before Flop (didn't bet)
Seat 2: raul marguer (small blind) folded on the Turn
Seat 3: amanso (big blind) collected (€0.04)
Seat 4: tag44399 folded before Flop (didn't bet)
Seat 5: Luckers712 folded before Flop (didn't bet)
Seat 6: chiwas12 folded before Flop (didn't bet)



PokerStars Zoom Hand #210156518259:  Hold'em No Limit (€0.01/€0.02) - 2020/03/15 14:47:53 CET [2020/03/15 9:47:53 ET]
Table 'Arneb' 6-max Seat #1 is the button
Seat 1: BARABU1314 (€2.59 in chips)
Seat 2: 11.M.R.K.11 (€2.59 in chips)
Seat 3: Luckers712 (€2.66 in chips)
Seat 4: eD_brump (€3.61 in chips)
Seat 5: Dark_make632 (€2.47 in chips)
Seat 6: driktony (€1.97 in chips)
11.M.R.K.11: posts small blind €0.01
Luckers712: posts big blind €0.02
*** HOLE CARDS ***
Dealt to Luckers712 [Th 6h]
eD_brump: folds
Dark_make632: folds
driktony: raises €0.04 to €0.06
BARABU1314: folds
11.M.R.K.11: folds
Luckers712: raises €0.12 to €0.18
driktony: calls €0.12
*** FLOP *** [Ac Td 3c]
Luckers712: bets €0.20
driktony: calls €0.20
*** TURN *** [Ac Td 3c] [7h]
Luckers712: checks
driktony: checks
*** RIVER *** [Ac Td 3c 7h] [8h]
Luckers712: checks
driktony: checks
*** SHOW DOWN ***
Luckers712: shows [Th 6h] (a pair of Tens)
driktony: shows [5h Ah] (a pair of Aces)
driktony collected €0.73 from pot
*** SUMMARY ***
Total pot €0.77 | Rake €0.04
Board [Ac Td 3c 7h 8h]
Seat 1: BARABU1314 (button) folded before Flop (didn't bet)
Seat 2: 11.M.R.K.11 (small blind) folded before Flop
Seat 3: Luckers712 (big blind) showed [Th 6h] and lost with a pair of Tens
Seat 4: eD_brump folded before Flop (didn't bet)
Seat 5: Dark_make632 folded before Flop (didn't bet)
Seat 6: driktony showed [5h Ah] and won (€0.73) with a pair of Aces



PokerStars Zoom Hand #210156554255:  Hold'em No Limit (€0.01/€0.02) - 2020/03/15 14:48:53 CET [2020/03/15 9:48:53 ET]
Table 'Arneb' 6-max Seat #1 is the button
Seat 1: Luckers712 (€2.28 in chips)
Seat 2: maritz12 (€2.88 in chips)
Seat 3: driktony (€2.32 in chips)
Seat 4: B.Tnecniv (€0.93 in chips)
Seat 5: Dark_make632 (€2.21 in chips)
Seat 6: CroweN007 (€0.44 in chips)
maritz12: posts small blind €0.01
driktony: posts big blind €0.02
*** HOLE CARDS ***
Dealt to Luckers712 [7h 6c]
B.Tnecniv: folds
Dark_make632: folds
CroweN007: folds
Luckers712: folds
maritz12: folds
Uncalled bet (€0.01) returned to driktony
driktony collected €0.02 from pot
driktony: doesn't show hand
*** SUMMARY ***
Total pot €0.02 | Rake €0
Seat 1: Luckers712 (button) folded before Flop (didn't bet)
Seat 2: maritz12 (small blind) folded before Flop
Seat 3: driktony (big blind) collected (€0.02)
Seat 4: B.Tnecniv folded before Flop (didn't bet)
Seat 5: Dark_make632 folded before Flop (didn't bet)
Seat 6: CroweN007 folded before Flop (didn't bet)



PokerStars Zoom Hand #210156558387:  Hold'em No Limit (€0.01/€0.02) - 2020/03/15 14:49:00 CET [2020/03/15 9:49:00 ET]
Table 'Arneb' 6-max Seat #1 is the button
Seat 1: ernestodpm (€2.66 in chips)
Seat 2: Luckers712 (€2.28 in chips)
Seat 3: maritz12 (€2.87 in chips)
Seat 4: DLA6 (€1.42 in chips)
Seat 5: riazorclub (€1.86 in chips)
Seat 6: pintotuga69 (€2.02 in chips)
Luckers712: posts small blind €0.01
maritz12: posts big blind €0.02
*** HOLE CARDS ***
Dealt to Luckers712 [9c 3h]
DLA6: folds
riazorclub: folds
pintotuga69: folds
ernestodpm: raises €0.04 to €0.06
Luckers712: folds
maritz12: folds
Uncalled bet (€0.04) returned to ernestodpm
ernestodpm collected €0.05 from pot
ernestodpm: doesn't show hand
*** SUMMARY ***
Total pot €0.05 | Rake €0
Seat 1: ernestodpm (button) collected (€0.05)
Seat 2: Luckers712 (small blind) folded before Flop
Seat 3: maritz12 (big blind) folded before Flop
Seat 4: DLA6 folded before Flop (didn't bet)
Seat 5: riazorclub folded before Flop (didn't bet)
Seat 6: pintotuga69 folded before Flop (didn't bet)



PokerStars Zoom Hand #210156563076:  Hold'em No Limit (€0.01/€0.02) - 2020/03/15 14:49:08 CET [2020/03/15 9:49:08 ET]
Table 'Arneb' 6-max Seat #1 is the button
Seat 1: Luckers712 (€2.27 in chips)
Seat 2: Veesile (€2 in chips)
Seat 3: Knize10 (€2 in chips)
Seat 4: jbrancobl (€2.31 in chips)
Seat 5: HeKaDeNuuK (€2 in chips)
Seat 6: NanoLMP (€2.64 in chips)
Veesile: posts small blind €0.01
Knize10: posts big blind €0.02
*** HOLE CARDS ***
Dealt to Luckers712 [As 6s]
jbrancobl: folds
HeKaDeNuuK: folds
NanoLMP: folds
Luckers712: raises €0.03 to €0.05
Veesile: folds
Knize10: folds
Uncalled bet (€0.03) returned to Luckers712
Luckers712 collected €0.05 from pot
Luckers712: doesn't show hand
*** SUMMARY ***
Total pot €0.05 | Rake €0
Seat 1: Luckers712 (button) collected (€0.05)
Seat 2: Veesile (small blind) folded before Flop
Seat 3: Knize10 (big blind) folded before Flop
Seat 4: jbrancobl folded before Flop (didn't bet)
Seat 5: HeKaDeNuuK folded before Flop (didn't bet)
Seat 6: NanoLMP folded before Flop (didn't bet)



PokerStars Zoom Hand #210156560700:  Hold'em No Limit (€0.01/€0.02) - 2020/03/15 14:49:04 CET [2020/03/15 9:49:04 ET]
Table 'Arneb' 6-max Seat #1 is the button
Seat 1: Rppopy (€2.42 in chips)
Seat 2: bandittours (€2.15 in chips)
Seat 3: jl le canari (€1.68 in chips)
Seat 4: tag44399 (€4.52 in chips)
Seat 5: My Udacha (€2.31 in chips)
Seat 6: Luckers712 (€2.27 in chips)
bandittours: posts small blind €0.01
jl le canari: posts big blind €0.02
*** HOLE CARDS ***
Dealt to Luckers712 [Qc 2h]
tag44399: folds
My Udacha: raises €0.04 to €0.06
Luckers712: folds
Rppopy: folds
bandittours: folds
jl le canari: calls €0.04
*** FLOP *** [Qs 8s 6c]
jl le canari: checks
My Udacha: checks
*** TURN *** [Qs 8s 6c] [Td]
jl le canari: checks
My Udacha: checks
*** RIVER *** [Qs 8s 6c Td] [9c]
jl le canari: bets €0.12
My Udacha: folds
Uncalled bet (€0.12) returned to jl le canari
jl le canari collected €0.12 from pot
jl le canari: doesn't show hand
*** SUMMARY ***
Total pot €0.13 | Rake €0.01
Board [Qs 8s 6c Td 9c]
Seat 1: Rppopy (button) folded before Flop (didn't bet)
Seat 2: bandittours (small blind) folded before Flop
Seat 3: jl le canari (big blind) collected (€0.12)
Seat 4: tag44399 folded before Flop (didn't bet)
Seat 5: My Udacha folded on the River
Seat 6: Luckers712 folded before Flop (didn't bet)



PokerStars Zoom Hand #210156587141:  Hold'em No Limit (€0.01/€0.02) - 2020/03/15 14:49:45 CET [2020/03/15 9:49:45 ET]
Table 'Arneb' 6-max Seat #1 is the button
Seat 1: seto1001 (€2.10 in chips)
Seat 2: JULGS (€1.03 in chips)
Seat 3: in-the-pool14 (€3.58 in chips)
Seat 4: Luckers712 (€2.30 in chips)
Seat 5: Zé Zé Sete (€1.50 in chips)
Seat 6: NanoLMP (€2.56 in chips)
JULGS: posts small blind €0.01
in-the-pool14: posts big blind €0.02
*** HOLE CARDS ***
Dealt to Luckers712 [Ks 5s]
Luckers712: folds
Zé Zé Sete: folds
NanoLMP: folds
seto1001: folds
JULGS: raises €0.02 to €0.04
in-the-pool14: calls €0.02
*** FLOP *** [4h 8d 4c]
JULGS: bets €0.04
in-the-pool14: folds
Uncalled bet (€0.04) returned to JULGS
JULGS collected €0.08 from pot
JULGS: doesn't show hand
*** SUMMARY ***
Total pot €0.08 | Rake €0
Board [4h 8d 4c]
Seat 1: seto1001 (button) folded before Flop (didn't bet)
Seat 2: JULGS (small blind) collected (€0.08)
Seat 3: in-the-pool14 (big blind) folded on the Flop
Seat 4: Luckers712 folded before Flop (didn't bet)
Seat 5: Zé Zé Sete folded before Flop (didn't bet)
Seat 6: NanoLMP folded before Flop (didn't bet)



PokerStars Zoom Hand #210156584753:  Hold'em No Limit (€0.01/€0.02) - 2020/03/15 14:49:41 CET [2020/03/15 9:49:41 ET]
Table 'Arneb' 6-max Seat #1 is the button
Seat 1: HarmoBlues (€10.95 in chips)
Seat 2: m.martines (€2.66 in chips)
Seat 3: Veesile (€2 in chips)
Seat 4: j0hnsaITM (€1.13 in chips)
Seat 5: Luckers712 (€2.30 in chips)
Seat 6: Dark_make632 (€2 in chips)
m.martines: posts small blind €0.01
Veesile: posts big blind €0.02
*** HOLE CARDS ***
Dealt to Luckers712 [6c Ks]
j0hnsaITM: folds
Luckers712: folds
Dark_make632: folds
HarmoBlues: calls €0.02
m.martines: raises €0.04 to €0.06
Veesile: folds
HarmoBlues: calls €0.04
*** FLOP *** [Qc 9h 7s]
m.martines: bets €0.06
HarmoBlues: folds
Uncalled bet (€0.06) returned to m.martines
m.martines collected €0.13 from pot
m.martines: doesn't show hand
*** SUMMARY ***
Total pot €0.14 | Rake €0.01
Board [Qc 9h 7s]
Seat 1: HarmoBlues (button) folded on the Flop
Seat 2: m.martines (small blind) collected (€0.13)
Seat 3: Veesile (big blind) folded before Flop
Seat 4: j0hnsaITM folded before Flop (didn't bet)
Seat 5: Luckers712 folded before Flop (didn't bet)
Seat 6: Dark_make632 folded before Flop (didn't bet)



PokerStars Zoom Hand #210156593272:  Hold'em No Limit (€0.01/€0.02) - 2020/03/15 14:49:55 CET [2020/03/15 9:49:55 ET]
Table 'Arneb' 6-max Seat #1 is the button
Seat 1: driktony (€2.31 in chips)
Seat 2: Dark_make632 (€2.18 in chips)
Seat 3: Luckers712 (€2.30 in chips)
Seat 4: unounoporfavor (€2 in chips)
Seat 5: detlef (€2.30 in chips)
Seat 6: triatlon23 (€2 in chips)
Dark_make632: posts small blind €0.01
Luckers712: posts big blind €0.02
*** HOLE CARDS ***
Dealt to Luckers712 [9s Td]
unounoporfavor: folds
detlef: folds
triatlon23: folds
driktony: raises €0.04 to €0.06
Dark_make632: folds
Luckers712: calls €0.04
*** FLOP *** [4h Jh 5c]
Luckers712: checks
driktony: bets €0.06
Luckers712: folds
Uncalled bet (€0.06) returned to driktony
driktony collected €0.12 from pot
*** SUMMARY ***
Total pot €0.13 | Rake €0.01
Board [4h Jh 5c]
Seat 1: driktony (button) collected (€0.12)
Seat 2: Dark_make632 (small blind) folded before Flop
Seat 3: Luckers712 (big blind) folded on the Flop
Seat 4: unounoporfavor folded before Flop (didn't bet)
Seat 5: detlef folded before Flop (didn't bet)
Seat 6: triatlon23 folded before Flop (didn't bet)



PokerStars Zoom Hand #210156612071:  Hold'em No Limit (€0.01/€0.02) - 2020/03/15 14:50:26 CET [2020/03/15 9:50:26 ET]
Table 'Arneb' 6-max Seat #1 is the button
Seat 1: campanilla06 (€2 in chips)
Seat 2: Luckers712 (€2.24 in chips)
Seat 3: FreudMind (€1.68 in chips)
Seat 4: thewithman (€4.09 in chips)
Seat 5: regpan3409 (€1.79 in chips)
Seat 6: detlef (€2.28 in chips)
Luckers712: posts small blind €0.01
FreudMind: posts big blind €0.02
*** HOLE CARDS ***
Dealt to Luckers712 [Qc Kc]
thewithman: raises €0.02 to €0.04
regpan3409: folds
detlef: folds
campanilla06: folds
Luckers712: calls €0.03
FreudMind: calls €0.02
*** FLOP *** [As 8d 9d]
Luckers712: checks
FreudMind: checks
thewithman: bets €0.11
Luckers712: folds
FreudMind: folds
Uncalled bet (€0.11) returned to thewithman
thewithman collected €0.11 from pot
thewithman: doesn't show hand
*** SUMMARY ***
Total pot €0.12 | Rake €0.01
Board [As 8d 9d]
Seat 1: campanilla06 (button) folded before Flop (didn't bet)
Seat 2: Luckers712 (small blind) folded on the Flop
Seat 3: FreudMind (big blind) folded on the Flop
Seat 4: thewithman collected (€0.11)
Seat 5: regpan3409 folded before Flop (didn't bet)
Seat 6: detlef folded before Flop (didn't bet)



PokerStars Zoom Hand #210156629052:  Hold'em No Limit (€0.01/€0.02) - 2020/03/15 14:50:54 CET [2020/03/15 9:50:54 ET]
Table 'Arneb' 6-max Seat #1 is the button
Seat 1: Luckers712 (€2.20 in chips)
Seat 2: JOHNNYDU42 (€3.27 in chips)
Seat 3: FullonMorning (€2.69 in chips)
Seat 4: juuanito128 (€4.58 in chips)
Seat 5: DNooXLvv (€2 in chips)
Seat 6: Veesile (€2 in chips)
JOHNNYDU42: posts small blind €0.01
FullonMorning: posts big blind €0.02
*** HOLE CARDS ***
Dealt to Luckers712 [Qd 9s]
juuanito128: calls €0.02
DNooXLvv: folds
Veesile: folds
Luckers712: calls €0.02
JOHNNYDU42: calls €0.01
FullonMorning: checks
*** FLOP *** [As Ts Ad]
JOHNNYDU42: checks
FullonMorning: checks
juuanito128: bets €0.06
Luckers712: folds
JOHNNYDU42: folds
FullonMorning: folds
Uncalled bet (€0.06) returned to juuanito128
juuanito128 collected €0.08 from pot
juuanito128: doesn't show hand
*** SUMMARY ***
Total pot €0.08 | Rake €0
Board [As Ts Ad]
Seat 1: Luckers712 (button) folded on the Flop
Seat 2: JOHNNYDU42 (small blind) folded on the Flop
Seat 3: FullonMorning (big blind) folded on the Flop
Seat 4: juuanito128 collected (€0.08)
Seat 5: DNooXLvv folded before Flop (didn't bet)
Seat 6: Veesile folded before Flop (didn't bet)



PokerStars Zoom Hand #210156656785:  Hold'em No Limit (€0.01/€0.02) - 2020/03/15 14:51:40 CET [2020/03/15 9:51:40 ET]
Table 'Arneb' 6-max Seat #1 is the button
Seat 1: pacacas (€2 in chips)
Seat 2: mue_16v (€2.03 in chips)
Seat 3: payoviejo (€2.37 in chips)
Seat 4: Vitorhcsousa (€4.56 in chips)
Seat 5: Luckers712 (€2.18 in chips)
Seat 6: passinha_scp (€2.75 in chips)
mue_16v: posts small blind €0.01
payoviejo: posts big blind €0.02
*** HOLE CARDS ***
Dealt to Luckers712 [9c 5h]
Vitorhcsousa: folds
Luckers712: folds
passinha_scp: folds
pacacas: folds
mue_16v: folds
Uncalled bet (€0.01) returned to payoviejo
payoviejo collected €0.02 from pot
payoviejo: doesn't show hand
*** SUMMARY ***
Total pot €0.02 | Rake €0
Seat 1: pacacas (button) folded before Flop (didn't bet)
Seat 2: mue_16v (small blind) folded before Flop
Seat 3: payoviejo (big blind) collected (€0.02)
Seat 4: Vitorhcsousa folded before Flop (didn't bet)
Seat 5: Luckers712 folded before Flop (didn't bet)
Seat 6: passinha_scp folded before Flop (didn't bet)



PokerStars Zoom Hand #210156661650:  Hold'em No Limit (€0.01/€0.02) - 2020/03/15 14:51:48 CET [2020/03/15 9:51:48 ET]
Table 'Arneb' 6-max Seat #1 is the button
Seat 1: VárzeaCity (€2.12 in chips)
Seat 2: xustra (€1.99 in chips)
Seat 3: Luckers712 (€2.18 in chips)
Seat 4: saulb16 (€3.51 in chips)
Seat 5: Ozzyuru_9 (€1.94 in chips)
Seat 6: triatlon23 (€2 in chips)
xustra: posts small blind €0.01
Luckers712: posts big blind €0.02
*** HOLE CARDS ***
Dealt to Luckers712 [2c Jh]
saulb16: folds
Ozzyuru_9: raises €0.04 to €0.06
triatlon23: raises €0.18 to €0.24
VárzeaCity: folds
xustra: folds
Luckers712: folds
Ozzyuru_9: folds
Uncalled bet (€0.18) returned to triatlon23
triatlon23 collected €0.15 from pot
triatlon23: doesn't show hand
*** SUMMARY ***
Total pot €0.15 | Rake €0
Seat 1: VárzeaCity (button) folded before Flop (didn't bet)
Seat 2: xustra (small blind) folded before Flop
Seat 3: Luckers712 (big blind) folded before Flop
Seat 4: saulb16 folded before Flop (didn't bet)
Seat 5: Ozzyuru_9 folded before Flop
Seat 6: triatlon23 collected (€0.15)



PokerStars Zoom Hand #210156654395:  Hold'em No Limit (€0.01/€0.02) - 2020/03/15 14:51:36 CET [2020/03/15 9:51:36 ET]
Table 'Arneb' 6-max Seat #1 is the button
Seat 1: juuanito128 (€4.64 in chips)
Seat 2: ALeX - ef0 (€1.97 in chips)
Seat 3: pabmesa (€2.07 in chips)
Seat 4: triatlon23 (€2 in chips)
Seat 5: cyrilus1705 (€2.13 in chips)
Seat 6: Luckers712 (€2.18 in chips)
ALeX - ef0: posts small blind €0.01
pabmesa: posts big blind €0.02
*** HOLE CARDS ***
Dealt to Luckers712 [6d 8h]
triatlon23: folds
cyrilus1705: folds
Luckers712: folds
juuanito128: calls €0.02
ALeX - ef0: calls €0.01
pabmesa: checks
*** FLOP *** [4d Th Kh]
ALeX - ef0: bets €0.03
pabmesa: folds
juuanito128: calls €0.03
*** TURN *** [4d Th Kh] [Ts]
ALeX - ef0: bets €0.06
juuanito128: calls €0.06
*** RIVER *** [4d Th Kh Ts] [8d]
ALeX - ef0: checks
juuanito128: bets €0.10
ALeX - ef0: folds
Uncalled bet (€0.10) returned to juuanito128
juuanito128 collected €0.23 from pot
juuanito128: doesn't show hand
*** SUMMARY ***
Total pot €0.24 | Rake €0.01
Board [4d Th Kh Ts 8d]
Seat 1: juuanito128 (button) collected (€0.23)
Seat 2: ALeX - ef0 (small blind) folded on the River
Seat 3: pabmesa (big blind) folded on the Flop
Seat 4: triatlon23 folded before Flop (didn't bet)
Seat 5: cyrilus1705 folded before Flop (didn't bet)
Seat 6: Luckers712 folded before Flop (didn't bet)



PokerStars Zoom Hand #210156669581:  Hold'em No Limit (€0.01/€0.02) - 2020/03/15 14:52:01 CET [2020/03/15 9:52:01 ET]
Table 'Arneb' 6-max Seat #1 is the button
Seat 1: Luckers712 (€2.15 in chips)
Seat 2: MaurusT (€2.22 in chips)
Seat 3: Javi Jotta (€2.07 in chips)
Seat 4: Ozzyuru_9 (€2.83 in chips)
Seat 5: thewithman (€4.76 in chips)
Seat 6: Bwotah (€3.36 in chips)
MaurusT: posts small blind €0.01
Javi Jotta: posts big blind €0.02
*** HOLE CARDS ***
Dealt to Luckers712 [Kc Ks]
Ozzyuru_9: raises €0.02 to €0.04
thewithman: calls €0.04
Bwotah: folds
Luckers712: raises €0.16 to €0.20
MaurusT: folds
Javi Jotta: folds
Ozzyuru_9: folds
thewithman: folds
Uncalled bet (€0.16) returned to Luckers712
Luckers712 collected €0.15 from pot
Luckers712: doesn't show hand
*** SUMMARY ***
Total pot €0.15 | Rake €0
Seat 1: Luckers712 (button) collected (€0.15)
Seat 2: MaurusT (small blind) folded before Flop
Seat 3: Javi Jotta (big blind) folded before Flop
Seat 4: Ozzyuru_9 folded before Flop
Seat 5: thewithman folded before Flop
Seat 6: Bwotah folded before Flop (didn't bet)



PokerStars Zoom Hand #210156688511:  Hold'em No Limit (€0.01/€0.02) - 2020/03/15 14:52:32 CET [2020/03/15 9:52:32 ET]
Table 'Arneb' 6-max Seat #1 is the button
Seat 1: mdlfa83 (€1.85 in chips)
Seat 2: riazorclub (€3.19 in chips)
Seat 3: wilbor123 (€4.27 in chips)
Seat 4: GuilleWilly1 (€3.43 in chips)
Seat 5: Luckers712 (€2.26 in chips)
Seat 6: Dark_make632 (€2.05 in chips)
riazorclub: posts small blind €0.01
wilbor123: posts big blind €0.02
*** HOLE CARDS ***
Dealt to Luckers712 [Kc 2h]
GuilleWilly1: raises €0.04 to €0.06
Luckers712: folds
Dark_make632: raises €0.12 to €0.18
mdlfa83: folds
riazorclub: folds
wilbor123: folds
GuilleWilly1: folds
Uncalled bet (€0.12) returned to Dark_make632
Dark_make632 collected €0.15 from pot
Dark_make632: doesn't show hand
*** SUMMARY ***
Total pot €0.15 | Rake €0
Seat 1: mdlfa83 (button) folded before Flop (didn't bet)
Seat 2: riazorclub (small blind) folded before Flop
Seat 3: wilbor123 (big blind) folded before Flop
Seat 4: GuilleWilly1 folded before Flop
Seat 5: Luckers712 folded before Flop (didn't bet)
Seat 6: Dark_make632 collected (€0.15)



PokerStars Zoom Hand #210156667119:  Hold'em No Limit (€0.01/€0.02) - 2020/03/15 14:51:57 CET [2020/03/15 9:51:57 ET]
Table 'Arneb' 6-max Seat #1 is the button
Seat 1: Veesile (€2 in chips)
Seat 2: Luckers712 (€2.16 in chips)
Seat 3: wilbor123 (€4.29 in chips)
Seat 4: riazorclub (€2.06 in chips)
Seat 5: DNooXLvv (€9.03 in chips)
Seat 6: Zorbec 1er (€2 in chips)
Luckers712: posts small blind €0.01
wilbor123: posts big blind €0.02
*** HOLE CARDS ***
Dealt to Luckers712 [3h 6c]
riazorclub: raises €0.04 to €0.06
DNooXLvv: raises €0.11 to €0.17
Zorbec 1er: folds
Veesile: folds
Luckers712: folds
wilbor123: folds
riazorclub: calls €0.11
*** FLOP *** [7s 8h 9s]
riazorclub: checks
DNooXLvv: bets €0.12
riazorclub: raises €0.30 to €0.42
DNooXLvv: calls €0.30
*** TURN *** [7s 8h 9s] [9c]
riazorclub: bets €1.47 and is all-in
DNooXLvv: calls €1.47
*** RIVER *** [7s 8h 9s 9c] [Tc]
*** SHOW DOWN ***
riazorclub: shows [8s As] (two pair, Nines and Eights)
DNooXLvv: shows [Qc Qh] (two pair, Queens and Nines)
DNooXLvv collected €3.94 from pot
*** SUMMARY ***
Total pot €4.15 | Rake €0.21
Board [7s 8h 9s 9c Tc]
Seat 1: Veesile (button) folded before Flop (didn't bet)
Seat 2: Luckers712 (small blind) folded before Flop
Seat 3: wilbor123 (big blind) folded before Flop
Seat 4: riazorclub showed [8s As] and lost with two pair, Nines and Eights
Seat 5: DNooXLvv showed [Qc Qh] and won (€3.94) with two pair, Queens and Nines
Seat 6: Zorbec 1er folded before Flop (didn't bet)



PokerStars Zoom Hand #210156684757:  Hold'em No Limit (€0.01/€0.02) - 2020/03/15 14:52:26 CET [2020/03/15 9:52:26 ET]
Table 'Arneb' 6-max Seat #1 is the button
Seat 1: BARABU1314 (€2.78 in chips)
Seat 2: FreudMind (€1.78 in chips)
Seat 3: jacksparr485 (€3.90 in chips)
Seat 4: ernestodpm (€4.66 in chips)
Seat 5: xustra (€1.98 in chips)
Seat 6: Luckers712 (€2.26 in chips)
FreudMind: posts small blind €0.01
jacksparr485: posts big blind €0.02
*** HOLE CARDS ***
Dealt to Luckers712 [5c Qs]
ernestodpm: calls €0.02
xustra: folds
Luckers712: folds
BARABU1314: calls €0.02
FreudMind: folds
jacksparr485: checks
*** FLOP *** [8s Jc 5d]
jacksparr485: checks
ernestodpm: checks
BARABU1314: checks
*** TURN *** [8s Jc 5d] [Th]
jacksparr485: checks
ernestodpm: checks
BARABU1314: bets €0.06
jacksparr485: folds
ernestodpm: folds
Uncalled bet (€0.06) returned to BARABU1314
BARABU1314 collected €0.07 from pot
BARABU1314: doesn't show hand
*** SUMMARY ***
Total pot €0.07 | Rake €0
Board [8s Jc 5d Th]
Seat 1: BARABU1314 (button) collected (€0.07)
Seat 2: FreudMind (small blind) folded before Flop
Seat 3: jacksparr485 (big blind) folded on the Turn
Seat 4: ernestodpm folded on the Turn
Seat 5: xustra folded before Flop (didn't bet)
Seat 6: Luckers712 folded before Flop (didn't bet)



PokerStars Zoom Hand #210156691516:  Hold'em No Limit (€0.01/€0.02) - 2020/03/15 14:52:37 CET [2020/03/15 9:52:37 ET]
Table 'Arneb' 6-max Seat #1 is the button
Seat 1: PavelVasilek (€4.20 in chips)
Seat 2: Jilguero24 (€2.18 in chips)
Seat 3: DNooXLvv (€4.43 in chips)
Seat 4: Luckers712 (€2.26 in chips)
Seat 5: driktony (€0.20 in chips)
Seat 6: varosex (€2.01 in chips)
Jilguero24: posts small blind €0.01
DNooXLvv: posts big blind €0.02
*** HOLE CARDS ***
Dealt to Luckers712 [Ks Qc]
Luckers712: raises €0.04 to €0.06
driktony: folds
varosex has timed out while disconnected
varosex: folds
PavelVasilek: folds
Jilguero24: calls €0.05
DNooXLvv: folds
*** FLOP *** [Td 6d Kc]
Jilguero24: checks
Luckers712: checks
*** TURN *** [Td 6d Kc] [8h]
Jilguero24: checks
Luckers712: bets €0.09
Jilguero24: calls €0.09
*** RIVER *** [Td 6d Kc 8h] [3d]
Jilguero24: bets €0.30
Luckers712: calls €0.30
*** SHOW DOWN ***
Jilguero24: shows [Jh 4h] (high card King)
Luckers712: shows [Ks Qc] (a pair of Kings)
Luckers712 collected €0.87 from pot
*** SUMMARY ***
Total pot €0.92 | Rake €0.05
Board [Td 6d Kc 8h 3d]
Seat 1: PavelVasilek (button) folded before Flop (didn't bet)
Seat 2: Jilguero24 (small blind) showed [Jh 4h] and lost with high card King
Seat 3: DNooXLvv (big blind) folded before Flop
Seat 4: Luckers712 showed [Ks Qc] and won (€0.87) with a pair of Kings
Seat 5: driktony folded before Flop (didn't bet)
Seat 6: varosex folded before Flop (didn't bet)



PokerStars Zoom Hand #210167287245:  Hold'em No Limit (€0.01/€0.02) - 2020/03/15 18:43:11 CET [2020/03/15 13:43:11 ET]
Table 'Arneb' 6-max Seat #1 is the button
Seat 1: ricmp (€12.68 in chips)
Seat 2: toniton888 (€0.50 in chips)
Seat 3: Luckers712 (€2 in chips)
Seat 4: pandemon (€4.06 in chips)
Seat 5: ciclo230385 (€2.03 in chips)
Seat 6: javimagnu (€2.16 in chips)
toniton888: posts small blind €0.01
Luckers712: posts big blind €0.02
*** HOLE CARDS ***
Dealt to Luckers712 [Ac Ad]
pandemon: raises €0.04 to €0.06
ciclo230385: folds
javimagnu: folds
ricmp: folds
toniton888: folds
Luckers712 has timed out while disconnected
Luckers712: folds
Uncalled bet (€0.04) returned to pandemon
pandemon collected €0.05 from pot
pandemon: doesn't show hand
*** SUMMARY ***
Total pot €0.05 | Rake €0
Seat 1: ricmp (button) folded before Flop (didn't bet)
Seat 2: toniton888 (small blind) folded before Flop
Seat 3: Luckers712 (big blind) folded before Flop
Seat 4: pandemon collected (€0.05)
Seat 5: ciclo230385 folded before Flop (didn't bet)
Seat 6: javimagnu folded before Flop (didn't bet)



PokerStars Zoom Hand #210167314365:  Hold'em No Limit (€0.01/€0.02) - 2020/03/15 18:43:40 CET [2020/03/15 13:43:40 ET]
Table 'Arneb' 6-max Seat #1 is the button
Seat 1: F€€DmyBANK$ (€2.95 in chips)
Seat 2: Luckers712 (€1.98 in chips)
Seat 3: The dead97 (€4.63 in chips)
Seat 4: GMRusty (€2 in chips)
Seat 5: xSirc (€2 in chips)
Seat 6: Vitorero (€2 in chips)
Luckers712: posts small blind €0.01
The dead97: posts big blind €0.02
*** HOLE CARDS ***
Dealt to Luckers712 [4d Kh]
GMRusty: raises €0.04 to €0.06
xSirc: folds
Vitorero: folds
F€€DmyBANK$: raises €0.12 to €0.18
Luckers712: folds
The dead97: folds
GMRusty: calls €0.12
*** FLOP *** [Qh 8d 8c]
GMRusty: checks
F€€DmyBANK$: bets €0.12
GMRusty: folds
Uncalled bet (€0.12) returned to F€€DmyBANK$
F€€DmyBANK$ collected €0.37 from pot
F€€DmyBANK$: doesn't show hand
*** SUMMARY ***
Total pot €0.39 | Rake €0.02
Board [Qh 8d 8c]
Seat 1: F€€DmyBANK$ (button) collected (€0.37)
Seat 2: Luckers712 (small blind) folded before Flop
Seat 3: The dead97 (big blind) folded before Flop
Seat 4: GMRusty folded on the Flop
Seat 5: xSirc folded before Flop (didn't bet)
Seat 6: Vitorero folded before Flop (didn't bet)



PokerStars Zoom Hand #210167319999:  Hold'em No Limit (€0.01/€0.02) - 2020/03/15 18:43:46 CET [2020/03/15 13:43:46 ET]
Table 'Arneb' 6-max Seat #1 is the button
Seat 1: pastra352 (€2.18 in chips)
Seat 2: ricmp (€4.76 in chips)
Seat 3: lusto09 (€2.34 in chips)
Seat 4: Redbox615 (€2.01 in chips)
Seat 5: bilboubou78 (€2 in chips)
Seat 6: Luckers712 (€1.99 in chips)
ricmp: posts small blind €0.01
lusto09: posts big blind €0.02
*** HOLE CARDS ***
Dealt to Luckers712 [3h 9h]
Redbox615: folds
bilboubou78: folds
Luckers712: folds
pastra352: folds
ricmp: folds
Uncalled bet (€0.01) returned to lusto09
lusto09 collected €0.02 from pot
lusto09: doesn't show hand
*** SUMMARY ***
Total pot €0.02 | Rake €0
Seat 1: pastra352 (button) folded before Flop (didn't bet)
Seat 2: ricmp (small blind) folded before Flop
Seat 3: lusto09 (big blind) collected (€0.02)
Seat 4: Redbox615 folded before Flop (didn't bet)
Seat 5: bilboubou78 folded before Flop (didn't bet)
Seat 6: Luckers712 folded before Flop (didn't bet)



PokerStars Zoom Hand #210167323800:  Hold'em No Limit (€0.01/€0.02) - 2020/03/15 18:43:50 CET [2020/03/15 13:43:50 ET]
Table 'Arneb' 6-max Seat #1 is the button
Seat 1: Luckers712 (€1.99 in chips)
Seat 2: jmaigre (€0.87 in chips)
Seat 3: Vitorero (€2 in chips)
Seat 4: javigarrido8 (€1.93 in chips)
Seat 5: galodebarcelos (€3.66 in chips)
Seat 6: Romevk (€2.17 in chips)
jmaigre: posts small blind €0.01
Vitorero: posts big blind €0.02
*** HOLE CARDS ***
Dealt to Luckers712 [Ks 2s]
javigarrido8: raises €0.04 to €0.06
galodebarcelos: folds
Romevk: folds
Luckers712: calls €0.06
jmaigre: folds
Vitorero: folds
*** FLOP *** [9c 2h 2c]
javigarrido8: bets €0.05
Luckers712: calls €0.05
*** TURN *** [9c 2h 2c] [9s]
javigarrido8: bets €0.12
Luckers712: calls €0.12
*** RIVER *** [9c 2h 2c 9s] [6d]
javigarrido8: checks
Luckers712: checks
*** SHOW DOWN ***
javigarrido8: shows [Jc Qc] (two pair, Nines and Deuces)
Luckers712: shows [Ks 2s] (a full house, Deuces full of Nines)
Luckers712 collected €0.47 from pot
*** SUMMARY ***
Total pot €0.49 | Rake €0.02
Board [9c 2h 2c 9s 6d]
Seat 1: Luckers712 (button) showed [Ks 2s] and won (€0.47) with a full house, Deuces full of Nines
Seat 2: jmaigre (small blind) folded before Flop
Seat 3: Vitorero (big blind) folded before Flop
Seat 4: javigarrido8 showed [Jc Qc] and lost with two pair, Nines and Deuces
Seat 5: galodebarcelos folded before Flop (didn't bet)
Seat 6: Romevk folded before Flop (didn't bet)



PokerStars Zoom Hand #210167391666:  Hold'em No Limit (€0.01/€0.02) - 2020/03/15 18:45:03 CET [2020/03/15 13:45:03 ET]
Table 'Arneb' 6-max Seat #1 is the button
Seat 1: Pereira1959 (€3.24 in chips)
Seat 2: NanoLMP (€2.30 in chips)
Seat 3: Luckers712 (€2.23 in chips)
Seat 4: Chipburguer (€3.11 in chips)
Seat 5: javigarrido8 (€1.70 in chips)
Seat 6: galodebarcelos (€6.01 in chips)
NanoLMP: posts small blind €0.01
Luckers712: posts big blind €0.02
*** HOLE CARDS ***
Dealt to Luckers712 [3h 9d]
Chipburguer: folds
javigarrido8: folds
galodebarcelos: raises €0.04 to €0.06
Pereira1959: folds
NanoLMP: folds
Luckers712: folds
Uncalled bet (€0.04) returned to galodebarcelos
galodebarcelos collected €0.05 from pot
galodebarcelos: doesn't show hand
*** SUMMARY ***
Total pot €0.05 | Rake €0
Seat 1: Pereira1959 (button) folded before Flop (didn't bet)
Seat 2: NanoLMP (small blind) folded before Flop
Seat 3: Luckers712 (big blind) folded before Flop
Seat 4: Chipburguer folded before Flop (didn't bet)
Seat 5: javigarrido8 folded before Flop (didn't bet)
Seat 6: galodebarcelos collected (€0.05)



PokerStars Zoom Hand #210167400221:  Hold'em No Limit (€0.01/€0.02) - 2020/03/15 18:45:12 CET [2020/03/15 13:45:12 ET]
Table 'Arneb' 6-max Seat #1 is the button
Seat 1: GMRusty (€2 in chips)
Seat 2: senruedas_ (€2.20 in chips)
Seat 3: chapa1010 (€4.61 in chips)
Seat 4: PACTE76 (€2.76 in chips)
Seat 5: nervolous (€1.84 in chips)
Seat 6: Luckers712 (€2.21 in chips)
senruedas_: posts small blind €0.01
chapa1010: posts big blind €0.02
*** HOLE CARDS ***
Dealt to Luckers712 [Js Td]
PACTE76: folds
nervolous: folds
Luckers712: raises €0.03 to €0.05
GMRusty: folds
senruedas_: folds
chapa1010: calls €0.03
*** FLOP *** [Ks 4d 5c]
chapa1010: checks
Luckers712: checks
*** TURN *** [Ks 4d 5c] [2s]
chapa1010: bets €0.08
Luckers712: folds
Uncalled bet (€0.08) returned to chapa1010
chapa1010 collected €0.10 from pot
chapa1010: doesn't show hand
*** SUMMARY ***
Total pot €0.11 | Rake €0.01
Board [Ks 4d 5c 2s]
Seat 1: GMRusty (button) folded before Flop (didn't bet)
Seat 2: senruedas_ (small blind) folded before Flop
Seat 3: chapa1010 (big blind) collected (€0.10)
Seat 4: PACTE76 folded before Flop (didn't bet)
Seat 5: nervolous folded before Flop (didn't bet)
Seat 6: Luckers712 folded on the Turn



PokerStars Zoom Hand #210167429085:  Hold'em No Limit (€0.01/€0.02) - 2020/03/15 18:45:43 CET [2020/03/15 13:45:43 ET]
Table 'Arneb' 6-max Seat #1 is the button
Seat 1: crismatil (€2.85 in chips)
Seat 2: Luckers712 (€2.16 in chips)
Seat 3: belcebubu (€1.53 in chips)
Seat 4: PATJOCK (€1.85 in chips)
Seat 5: M5dias (€2.10 in chips)
Seat 6: albertito151 (€2 in chips)
Luckers712: posts small blind €0.01
belcebubu: posts big blind €0.02
*** HOLE CARDS ***
Dealt to Luckers712 [2h 9c]
PATJOCK: folds
M5dias: folds
albertito151: raises €0.03 to €0.05
crismatil: folds
Luckers712: folds
belcebubu: folds
Uncalled bet (€0.03) returned to albertito151
albertito151 collected €0.05 from pot
albertito151: doesn't show hand
*** SUMMARY ***
Total pot €0.05 | Rake €0
Seat 1: crismatil (button) folded before Flop (didn't bet)
Seat 2: Luckers712 (small blind) folded before Flop
Seat 3: belcebubu (big blind) folded before Flop
Seat 4: PATJOCK folded before Flop (didn't bet)
Seat 5: M5dias folded before Flop (didn't bet)
Seat 6: albertito151 collected (€0.05)



PokerStars Zoom Hand #210167432863:  Hold'em No Limit (€0.01/€0.02) - 2020/03/15 18:45:47 CET [2020/03/15 13:45:47 ET]
Table 'Arneb' 6-max Seat #1 is the button
Seat 1: Judelar (€2 in chips)
Seat 2: girao7 (€2.13 in chips)
Seat 3: PITI1231 (€7.60 in chips)
Seat 4: javimagnu (€2.45 in chips)
Seat 5: Luckers712 (€2.15 in chips)
Seat 6: ekzemaker (€5.99 in chips)
girao7: posts small blind €0.01
PITI1231: posts big blind €0.02
*** HOLE CARDS ***
Dealt to Luckers712 [6h 6s]
javimagnu: folds
Luckers712: raises €0.03 to €0.05
ekzemaker: folds
Judelar: folds
girao7: calls €0.04
PITI1231: folds
*** FLOP *** [As 7h 2d]
girao7: checks
Luckers712: checks
*** TURN *** [As 7h 2d] [7c]
girao7: checks
Luckers712: bets €0.05
girao7: folds
Uncalled bet (€0.05) returned to Luckers712
Luckers712 collected €0.11 from pot
Luckers712: doesn't show hand
*** SUMMARY ***
Total pot €0.12 | Rake €0.01
Board [As 7h 2d 7c]
Seat 1: Judelar (button) folded before Flop (didn't bet)
Seat 2: girao7 (small blind) folded on the Turn
Seat 3: PITI1231 (big blind) folded before Flop
Seat 4: javimagnu folded before Flop (didn't bet)
Seat 5: Luckers712 collected (€0.11)
Seat 6: ekzemaker folded before Flop (didn't bet)



PokerStars Zoom Hand #210167474288:  Hold'em No Limit (€0.01/€0.02) - 2020/03/15 18:46:31 CET [2020/03/15 13:46:31 ET]
Table 'Arneb' 6-max Seat #1 is the button
Seat 1: Torcador (€1.48 in chips)
Seat 2: sajoti (€1.55 in chips)
Seat 3: Luckers712 (€2.21 in chips)
Seat 4: tresiño (€1.91 in chips)
Seat 5: carlosmg410 (€1.93 in chips)
Seat 6: Galin1312 (€1.93 in chips)
sajoti: posts small blind €0.01
Luckers712: posts big blind €0.02
*** HOLE CARDS ***
Dealt to Luckers712 [6s 7h]
tresiño: folds
carlosmg410: folds
Galin1312: folds
Torcador: folds
sajoti: folds
Uncalled bet (€0.01) returned to Luckers712
Luckers712 collected €0.02 from pot
Luckers712: doesn't show hand
*** SUMMARY ***
Total pot €0.02 | Rake €0
Seat 1: Torcador (button) folded before Flop (didn't bet)
Seat 2: sajoti (small blind) folded before Flop
Seat 3: Luckers712 (big blind) collected (€0.02)
Seat 4: tresiño folded before Flop (didn't bet)
Seat 5: carlosmg410 folded before Flop (didn't bet)
Seat 6: Galin1312 folded before Flop (didn't bet)



PokerStars Zoom Hand #210167486472:  Hold'em No Limit (€0.01/€0.02) - 2020/03/15 18:46:44 CET [2020/03/15 13:46:44 ET]
Table 'Arneb' 6-max Seat #1 is the button
Seat 1: ERIZOCACHO (€0.67 in chips)
Seat 2: OCTAVIA POP (€2.55 in chips)
Seat 3: jmaigre (€1 in chips)
Seat 4: Luckers712 (€2.22 in chips)
Seat 5: ordisile (€2.19 in chips)
Seat 6: Redbox615 (€2.25 in chips)
OCTAVIA POP: posts small blind €0.01
jmaigre: posts big blind €0.02
*** HOLE CARDS ***
Dealt to Luckers712 [5d 9d]
Luckers712: folds
ordisile: raises €0.06 to €0.08
Redbox615: folds
ERIZOCACHO: folds
OCTAVIA POP: folds
jmaigre: folds
Uncalled bet (€0.06) returned to ordisile
ordisile collected €0.05 from pot
ordisile: doesn't show hand
*** SUMMARY ***
Total pot €0.05 | Rake €0
Seat 1: ERIZOCACHO (button) folded before Flop (didn't bet)
Seat 2: OCTAVIA POP (small blind) folded before Flop
Seat 3: jmaigre (big blind) folded before Flop
Seat 4: Luckers712 folded before Flop (didn't bet)
Seat 5: ordisile collected (€0.05)
Seat 6: Redbox615 folded before Flop (didn't bet)



PokerStars Zoom Hand #210167468639:  Hold'em No Limit (€0.01/€0.02) - 2020/03/15 18:46:25 CET [2020/03/15 13:46:25 ET]
Table 'Arneb' 6-max Seat #1 is the button
Seat 1: Luckers712 (€2.21 in chips)
Seat 2: xSirc (€2.17 in chips)
Seat 3: Capitan Aab (€2.03 in chips)
Seat 4: 9gef7 (€2.09 in chips)
Seat 5: ellen rypley (€0.94 in chips)
Seat 6: villagrasa28 (€11.71 in chips)
xSirc: posts small blind €0.01
Capitan Aab: posts big blind €0.02
*** HOLE CARDS ***
Dealt to Luckers712 [Td 4h]
9gef7: raises €0.04 to €0.06
ellen rypley: folds
villagrasa28: calls €0.06
Luckers712: folds
xSirc: folds
Capitan Aab: folds
*** FLOP *** [7d Kc Th]
9gef7: checks
villagrasa28: bets €0.14
9gef7: calls €0.14
*** TURN *** [7d Kc Th] [As]
9gef7: checks
villagrasa28: checks
*** RIVER *** [7d Kc Th As] [8d]
9gef7: bets €0.21
villagrasa28: calls €0.21
*** SHOW DOWN ***
9gef7: shows [Ad Jd] (a pair of Aces)
villagrasa28: mucks hand
9gef7 collected €0.81 from pot
*** SUMMARY ***
Total pot €0.85 | Rake €0.04
Board [7d Kc Th As 8d]
Seat 1: Luckers712 (button) folded before Flop (didn't bet)
Seat 2: xSirc (small blind) folded before Flop
Seat 3: Capitan Aab (big blind) folded before Flop
Seat 4: 9gef7 showed [Ad Jd] and won (€0.81) with a pair of Aces
Seat 5: ellen rypley folded before Flop (didn't bet)
Seat 6: villagrasa28 mucked [Tc Js]



PokerStars Zoom Hand #210167423576:  Hold'em No Limit (€0.01/€0.02) - 2020/03/15 18:45:37 CET [2020/03/15 13:45:37 ET]
Table 'Arneb' 6-max Seat #1 is the button
Seat 1: cocololo91 (€4.97 in chips)
Seat 2: xami87 (€1.51 in chips)
Seat 3: Hugo Alambre (€3.34 in chips)
Seat 4: girao7 (€2.13 in chips)
Seat 5: Luckers712 (€2.16 in chips)
Seat 6: JF 1711 (€1.13 in chips)
xami87: posts small blind €0.01
Hugo Alambre: posts big blind €0.02
*** HOLE CARDS ***
Dealt to Luckers712 [8s 5h]
girao7: folds
Luckers712: folds
JF 1711: raises €0.02 to €0.04
cocololo91: folds
xami87: folds
Hugo Alambre: calls €0.02
*** FLOP *** [7s Ac 5c]
Hugo Alambre: checks
JF 1711: bets €0.04
Hugo Alambre: calls €0.04
*** TURN *** [7s Ac 5c] [4s]
Hugo Alambre: checks
JF 1711: checks
*** RIVER *** [7s Ac 5c 4s] [As]
Hugo Alambre: bets €0.08
JF 1711: calls €0.08
*** SHOW DOWN ***
Hugo Alambre: shows [Tc 7h] (two pair, Aces and Sevens)
JF 1711: mucks hand
Hugo Alambre collected €0.31 from pot
*** SUMMARY ***
Total pot €0.33 | Rake €0.02
Board [7s Ac 5c 4s As]
Seat 1: cocololo91 (button) folded before Flop (didn't bet)
Seat 2: xami87 (small blind) folded before Flop
Seat 3: Hugo Alambre (big blind) showed [Tc 7h] and won (€0.31) with two pair, Aces and Sevens
Seat 4: girao7 folded before Flop (didn't bet)
Seat 5: Luckers712 folded before Flop (didn't bet)
Seat 6: JF 1711 mucked [Qd 4d]



PokerStars Zoom Hand #210167492135:  Hold'em No Limit (€0.01/€0.02) - 2020/03/15 18:46:50 CET [2020/03/15 13:46:50 ET]
Table 'Arneb' 6-max Seat #1 is the button
Seat 1: chapa1010 (€7.71 in chips)
Seat 2: praetorius39 (€2 in chips)
Seat 3: ekzemaker (€6.01 in chips)
Seat 4: Luckers712 (€2.22 in chips)
Seat 5: ElvasSniper (€3.15 in chips)
Seat 6: ocsur (€3.79 in chips)
praetorius39: posts small blind €0.01
ekzemaker: posts big blind €0.02
*** HOLE CARDS ***
Dealt to Luckers712 [Ac 8s]
Luckers712: folds
ElvasSniper: folds
ocsur: calls €0.02
chapa1010: calls €0.02
praetorius39: calls €0.01
ekzemaker: checks
*** FLOP *** [Ad 6h 9s]
praetorius39: checks
ekzemaker: checks
ocsur: bets €0.04
chapa1010: folds
praetorius39: folds
ekzemaker: folds
Uncalled bet (€0.04) returned to ocsur
ocsur collected €0.08 from pot
ocsur: doesn't show hand
*** SUMMARY ***
Total pot €0.08 | Rake €0
Board [Ad 6h 9s]
Seat 1: chapa1010 (button) folded on the Flop
Seat 2: praetorius39 (small blind) folded on the Flop
Seat 3: ekzemaker (big blind) folded on the Flop
Seat 4: Luckers712 folded before Flop (didn't bet)
Seat 5: ElvasSniper folded before Flop (didn't bet)
Seat 6: ocsur collected (€0.08)



PokerStars Zoom Hand #210167497734:  Hold'em No Limit (€0.01/€0.02) - 2020/03/15 18:46:56 CET [2020/03/15 13:46:56 ET]
Table 'Arneb' 6-max Seat #1 is the button
Seat 1: Luckers712 (€2.22 in chips)
Seat 2: jzamora2011 (€2.96 in chips)
Seat 3: perolete66 (€4.09 in chips)
Seat 4: javigarrido8 (€1.63 in chips)
Seat 5: plisskenn (€2.21 in chips)
Seat 6: PatrickVence (€3.63 in chips)
jzamora2011: posts small blind €0.01
perolete66: posts big blind €0.02
*** HOLE CARDS ***
Dealt to Luckers712 [Qs 7d]
javigarrido8: folds
plisskenn: folds
PatrickVence: calls €0.02
Luckers712: folds
jzamora2011: calls €0.01
perolete66: checks
*** FLOP *** [2s Qd Jh]
jzamora2011: checks
perolete66: checks
PatrickVence: checks
*** TURN *** [2s Qd Jh] [4d]
jzamora2011: checks
perolete66: checks
PatrickVence: checks
*** RIVER *** [2s Qd Jh 4d] [Th]
jzamora2011: checks
perolete66: checks
PatrickVence: checks
*** SHOW DOWN ***
jzamora2011: shows [Kc 8c] (high card King)
perolete66: mucks hand
PatrickVence: shows [4c Ac] (a pair of Fours)
PatrickVence collected €0.06 from pot
*** SUMMARY ***
Total pot €0.06 | Rake €0
Board [2s Qd Jh 4d Th]
Seat 1: Luckers712 (button) folded before Flop (didn't bet)
Seat 2: jzamora2011 (small blind) showed [Kc 8c] and lost with high card King
Seat 3: perolete66 (big blind) mucked [3c 8s]
Seat 4: javigarrido8 folded before Flop (didn't bet)
Seat 5: plisskenn folded before Flop (didn't bet)
Seat 6: PatrickVence showed [4c Ac] and won (€0.06) with a pair of Fours



PokerStars Zoom Hand #210167510105:  Hold'em No Limit (€0.01/€0.02) - 2020/03/15 18:47:09 CET [2020/03/15 13:47:09 ET]
Table 'Arneb' 6-max Seat #1 is the button
Seat 1: thehunterfox (€1.94 in chips)
Seat 2: Luckers712 (€2.22 in chips)
Seat 3: Tatxan (€1.39 in chips)
Seat 4: pandemon (€3.38 in chips)
Seat 5: Lbrt911 (€1.03 in chips)
Seat 6: ArqD0 (€1.38 in chips)
Luckers712: posts small blind €0.01
Tatxan: posts big blind €0.02
*** HOLE CARDS ***
Dealt to Luckers712 [4d 5d]
pandemon: folds
Lbrt911: folds
ArqD0: folds
thehunterfox: folds
Luckers712: raises €0.04 to €0.06
Tatxan: calls €0.04
*** FLOP *** [8c Tc Ks]
Luckers712: bets €0.06
Tatxan: calls €0.06
*** TURN *** [8c Tc Ks] [Ah]
Luckers712: bets €0.12
Tatxan: calls €0.12
*** RIVER *** [8c Tc Ks Ah] [Th]
Luckers712: checks
Tatxan: checks
*** SHOW DOWN ***
Luckers712: shows [4d 5d] (a pair of Tens)
Tatxan: shows [Qc Qs] (two pair, Queens and Tens)
Tatxan collected €0.46 from pot
*** SUMMARY ***
Total pot €0.48 | Rake €0.02
Board [8c Tc Ks Ah Th]
Seat 1: thehunterfox (button) folded before Flop (didn't bet)
Seat 2: Luckers712 (small blind) showed [4d 5d] and lost with a pair of Tens
Seat 3: Tatxan (big blind) showed [Qc Qs] and won (€0.46) with two pair, Queens and Tens
Seat 4: pandemon folded before Flop (didn't bet)
Seat 5: Lbrt911 folded before Flop (didn't bet)
Seat 6: ArqD0 folded before Flop (didn't bet)



PokerStars Zoom Hand #210167562433:  Hold'em No Limit (€0.01/€0.02) - 2020/03/15 18:48:05 CET [2020/03/15 13:48:05 ET]
Table 'Arneb' 6-max Seat #1 is the button
Seat 1: Meldu6938 (€1.52 in chips)
Seat 2: llodio (€2.38 in chips)
Seat 3: israel476 (€2.32 in chips)
Seat 4: o1o0o1o (€3.70 in chips)
Seat 5: albertito151 (€2.18 in chips)
Seat 6: Luckers712 (€1.98 in chips)
llodio: posts small blind €0.01
israel476: posts big blind €0.02
*** HOLE CARDS ***
Dealt to Luckers712 [6c 5c]
o1o0o1o has timed out while disconnected
o1o0o1o: folds
albertito151: folds
Luckers712: raises €0.03 to €0.05
Meldu6938: folds
llodio: folds
israel476: folds
Uncalled bet (€0.03) returned to Luckers712
Luckers712 collected €0.05 from pot
Luckers712: doesn't show hand
*** SUMMARY ***
Total pot €0.05 | Rake €0
Seat 1: Meldu6938 (button) folded before Flop (didn't bet)
Seat 2: llodio (small blind) folded before Flop
Seat 3: israel476 (big blind) folded before Flop
Seat 4: o1o0o1o folded before Flop (didn't bet)
Seat 5: albertito151 folded before Flop (didn't bet)
Seat 6: Luckers712 collected (€0.05)



PokerStars Zoom Hand #210167583039:  Hold'em No Limit (€0.01/€0.02) - 2020/03/15 18:48:27 CET [2020/03/15 13:48:27 ET]
Table 'Arneb' 6-max Seat #1 is the button
Seat 1: toniton888 (€0.93 in chips)
Seat 2: Judelar (€2 in chips)
Seat 3: sajoti (€1.58 in chips)
Seat 4: les_f1lous (€2.32 in chips)
Seat 5: Luckers712 (€2.01 in chips)
Seat 6: mohay20 (€2.64 in chips)
Judelar: posts small blind €0.01
sajoti: posts big blind €0.02
*** HOLE CARDS ***
Dealt to Luckers712 [2s 2d]
les_f1lous: folds
Luckers712: raises €0.03 to €0.05
mohay20: folds
toniton888: folds
Judelar: folds
sajoti: folds
Uncalled bet (€0.03) returned to Luckers712
Luckers712 collected €0.05 from pot
Luckers712: doesn't show hand
*** SUMMARY ***
Total pot €0.05 | Rake €0
Seat 1: toniton888 (button) folded before Flop (didn't bet)
Seat 2: Judelar (small blind) folded before Flop
Seat 3: sajoti (big blind) folded before Flop
Seat 4: les_f1lous folded before Flop (didn't bet)
Seat 5: Luckers712 collected (€0.05)
Seat 6: mohay20 folded before Flop (didn't bet)



PokerStars Zoom Hand #210167597127:  Hold'em No Limit (€0.01/€0.02) - 2020/03/15 18:48:42 CET [2020/03/15 13:48:42 ET]
Table 'Arneb' 6-max Seat #1 is the button
Seat 1: javimagnu (€2.15 in chips)
Seat 2: xSirc (€2.25 in chips)
Seat 3: LAROSA74 (€1.96 in chips)
Seat 4: Luckers712 (€2.04 in chips)
Seat 5: Anme41 (€3.67 in chips)
Seat 6: DNooXLvv (€2.30 in chips)
xSirc: posts small blind €0.01
LAROSA74: posts big blind €0.02
*** HOLE CARDS ***
Dealt to Luckers712 [5h Jh]
Luckers712: folds
Anme41: folds
DNooXLvv has timed out
DNooXLvv: folds
javimagnu: raises €0.04 to €0.06
xSirc: folds
LAROSA74: calls €0.04
*** FLOP *** [Jc 5c Ks]
LAROSA74: checks
javimagnu: bets €0.06
LAROSA74: calls €0.06
*** TURN *** [Jc 5c Ks] [Qs]
LAROSA74: checks
javimagnu: checks
*** RIVER *** [Jc 5c Ks Qs] [Js]
LAROSA74: checks
javimagnu: checks
*** SHOW DOWN ***
LAROSA74: shows [Qd 9c] (two pair, Queens and Jacks)
javimagnu: mucks hand
LAROSA74 collected €0.24 from pot
*** SUMMARY ***
Total pot €0.25 | Rake €0.01
Board [Jc 5c Ks Qs Js]
Seat 1: javimagnu (button) mucked [8s 8c]
Seat 2: xSirc (small blind) folded before Flop
Seat 3: LAROSA74 (big blind) showed [Qd 9c] and won (€0.24) with two pair, Queens and Jacks
Seat 4: Luckers712 folded before Flop (didn't bet)
Seat 5: Anme41 folded before Flop (didn't bet)
Seat 6: DNooXLvv folded before Flop (didn't bet)



PokerStars Zoom Hand #210167601978:  Hold'em No Limit (€0.01/€0.02) - 2020/03/15 18:48:47 CET [2020/03/15 13:48:47 ET]
Table 'Arneb' 6-max Seat #1 is the button
Seat 1: alestoral (€2.07 in chips)
Seat 2: chrisvlr65 (€1.97 in chips)
Seat 3: Luckers712 (€2.04 in chips)
Seat 4: Capitan Aab (€2 in chips)
Seat 5: senruedas_ (€2 in chips)
Seat 6: girao7 (€1.91 in chips)
chrisvlr65: posts small blind €0.01
Luckers712: posts big blind €0.02
*** HOLE CARDS ***
Dealt to Luckers712 [3c 8c]
Capitan Aab: folds
senruedas_: folds
girao7: raises €0.02 to €0.04
alestoral: calls €0.04
chrisvlr65: folds
Luckers712: calls €0.02
*** FLOP *** [2s Kc 2c]
Luckers712: bets €0.04
girao7: raises €0.04 to €0.08
alestoral: folds
Luckers712: calls €0.04
*** TURN *** [2s Kc 2c] [6c]
Luckers712: bets €0.14
girao7: raises €0.14 to €0.28
Luckers712: raises €0.22 to €0.50
girao7: raises €1.29 to €1.79 and is all-in
Luckers712: calls €1.29
*** RIVER *** [2s Kc 2c 6c] [8s]
*** SHOW DOWN ***
Luckers712: shows [3c 8c] (a flush, King high)
girao7: shows [Kh Kd] (a full house, Kings full of Deuces)
girao7 collected €3.68 from pot
*** SUMMARY ***
Total pot €3.87 | Rake €0.19
Board [2s Kc 2c 6c 8s]
Seat 1: alestoral (button) folded on the Flop
Seat 2: chrisvlr65 (small blind) folded before Flop
Seat 3: Luckers712 (big blind) showed [3c 8c] and lost with a flush, King high
Seat 4: Capitan Aab folded before Flop (didn't bet)
Seat 5: senruedas_ folded before Flop (didn't bet)
Seat 6: girao7 showed [Kh Kd] and won (€3.68) with a full house, Kings full of Deuces



PokerStars Zoom Hand #210167679686:  Hold'em No Limit (€0.01/€0.02) - 2020/03/15 18:50:10 CET [2020/03/15 13:50:10 ET]
Table 'Arneb' 6-max Seat #1 is the button
Seat 1: clarito sevi (€2.33 in chips)
Seat 2: 93valdo974 (€2.23 in chips)
Seat 3: bilboubou78 (€4.27 in chips)
Seat 4: eslavoneslavon (€1.41 in chips)
Seat 5: PakasLE (€3.65 in chips)
Seat 6: Luckers712 (€1.99 in chips)
93valdo974: posts small blind €0.01
bilboubou78: posts big blind €0.02
*** HOLE CARDS ***
Dealt to Luckers712 [Kc 7h]
eslavoneslavon: folds
PakasLE: raises €0.04 to €0.06
Luckers712: folds
clarito sevi: folds
93valdo974: folds
bilboubou78: folds
Uncalled bet (€0.04) returned to PakasLE
PakasLE collected €0.05 from pot
PakasLE: doesn't show hand
*** SUMMARY ***
Total pot €0.05 | Rake €0
Seat 1: clarito sevi (button) folded before Flop (didn't bet)
Seat 2: 93valdo974 (small blind) folded before Flop
Seat 3: bilboubou78 (big blind) folded before Flop
Seat 4: eslavoneslavon folded before Flop (didn't bet)
Seat 5: PakasLE collected (€0.05)
Seat 6: Luckers712 folded before Flop (didn't bet)



PokerStars Zoom Hand #210167684275:  Hold'em No Limit (€0.01/€0.02) - 2020/03/15 18:50:15 CET [2020/03/15 13:50:15 ET]
Table 'Arneb' 6-max Seat #1 is the button
Seat 1: Veesile (€2.10 in chips)
Seat 2: mikolapiz1 (€2.23 in chips)
Seat 3: Venturacamel (€1.58 in chips)
Seat 4: fcruz91 (€1.95 in chips)
Seat 5: Luckers712 (€1.99 in chips)
Seat 6: chrisvlr65 (€1.91 in chips)
mikolapiz1: posts small blind €0.01
Venturacamel: posts big blind €0.02
*** HOLE CARDS ***
Dealt to Luckers712 [3s 4s]
fcruz91: folds
Luckers712: raises €0.03 to €0.05
chrisvlr65: folds
Veesile: raises €0.13 to €0.18
mikolapiz1: folds
Venturacamel: folds
Luckers712: folds
Uncalled bet (€0.13) returned to Veesile
Veesile collected €0.13 from pot
Veesile: doesn't show hand
*** SUMMARY ***
Total pot €0.13 | Rake €0
Seat 1: Veesile (button) collected (€0.13)
Seat 2: mikolapiz1 (small blind) folded before Flop
Seat 3: Venturacamel (big blind) folded before Flop
Seat 4: fcruz91 folded before Flop (didn't bet)
Seat 5: Luckers712 folded before Flop
Seat 6: chrisvlr65 folded before Flop (didn't bet)



PokerStars Zoom Hand #210167671384:  Hold'em No Limit (€0.01/€0.02) - 2020/03/15 18:50:01 CET [2020/03/15 13:50:01 ET]
Table 'Arneb' 6-max Seat #1 is the button
Seat 1: Romevk (€1.98 in chips)
Seat 2: Luckers712 (€0.13 in chips)
Seat 3: MigDmaria (€2.02 in chips)
Seat 4: willyzas (€5.61 in chips)
Seat 5: xateadoo (€3.21 in chips)
Seat 6: patriacs (€2.53 in chips)
Luckers712: posts small blind €0.01
MigDmaria: posts big blind €0.02
*** HOLE CARDS ***
Dealt to Luckers712 [Kd 2h]
willyzas: folds
xateadoo: folds
patriacs: raises €0.04 to €0.06
Romevk: calls €0.06
Luckers712: folds
MigDmaria: folds
*** FLOP *** [7h 7s 9c]
patriacs: bets €0.06
Romevk: raises €0.26 to €0.32
patriacs: folds
Uncalled bet (€0.26) returned to Romevk
Romevk collected €0.26 from pot
Romevk: doesn't show hand
*** SUMMARY ***
Total pot €0.27 | Rake €0.01
Board [7h 7s 9c]
Seat 1: Romevk (button) collected (€0.26)
Seat 2: Luckers712 (small blind) folded before Flop
Seat 3: MigDmaria (big blind) folded before Flop
Seat 4: willyzas folded before Flop (didn't bet)
Seat 5: xateadoo folded before Flop (didn't bet)
Seat 6: patriacs folded on the Flop



PokerStars Zoom Hand #210167700128:  Hold'em No Limit (€0.01/€0.02) - 2020/03/15 18:50:32 CET [2020/03/15 13:50:32 ET]
Table 'Arneb' 6-max Seat #1 is the button
Seat 1: Luckers712 (€1.94 in chips)
Seat 2: FocusBuilder (€2.16 in chips)
Seat 3: fcruz91 (€2.36 in chips)
Seat 4: nervolous (€1.67 in chips)
Seat 5: usskul_44 (€0.92 in chips)
Seat 6: 00Spidy00 (€2 in chips)
FocusBuilder: posts small blind €0.01
fcruz91: posts big blind €0.02
*** HOLE CARDS ***
Dealt to Luckers712 [Kc 5d]
nervolous: folds
usskul_44: folds
00Spidy00: folds
Luckers712: raises €0.03 to €0.05
FocusBuilder: folds
fcruz91: folds
Uncalled bet (€0.03) returned to Luckers712
Luckers712 collected €0.05 from pot
Luckers712: doesn't show hand
*** SUMMARY ***
Total pot €0.05 | Rake €0
Seat 1: Luckers712 (button) collected (€0.05)
Seat 2: FocusBuilder (small blind) folded before Flop
Seat 3: fcruz91 (big blind) folded before Flop
Seat 4: nervolous folded before Flop (didn't bet)
Seat 5: usskul_44 folded before Flop (didn't bet)
Seat 6: 00Spidy00 folded before Flop (didn't bet)



PokerStars Zoom Hand #210167713949:  Hold'em No Limit (€0.01/€0.02) - 2020/03/15 18:50:47 CET [2020/03/15 13:50:47 ET]
Table 'Arneb' 6-max Seat #1 is the button
Seat 1: ElvasSniper (€2.35 in chips)
Seat 2: javimagnu (€2.05 in chips)
Seat 3: Luckers712 (€2 in chips)
Seat 4: Rfystar (€0.31 in chips)
Seat 5: o1o0o1o (€2.11 in chips)
Seat 6: jzamora2011 (€3.20 in chips)
javimagnu: posts small blind €0.01
Luckers712: posts big blind €0.02
*** HOLE CARDS ***
Dealt to Luckers712 [9h Kh]
Rfystar: folds
o1o0o1o: raises €0.04 to €0.06
jzamora2011: folds
ElvasSniper: folds
javimagnu: folds
Luckers712: calls €0.04
*** FLOP *** [Qd 4h 6s]
Luckers712: bets €0.06
o1o0o1o: folds
Uncalled bet (€0.06) returned to Luckers712
Luckers712 collected €0.12 from pot
Luckers712: doesn't show hand
*** SUMMARY ***
Total pot €0.13 | Rake €0.01
Board [Qd 4h 6s]
Seat 1: ElvasSniper (button) folded before Flop (didn't bet)
Seat 2: javimagnu (small blind) folded before Flop
Seat 3: Luckers712 (big blind) collected (€0.12)
Seat 4: Rfystar folded before Flop (didn't bet)
Seat 5: o1o0o1o folded on the Flop
Seat 6: jzamora2011 folded before Flop (didn't bet)



PokerStars Zoom Hand #210167739022:  Hold'em No Limit (€0.01/€0.02) - 2020/03/15 18:51:14 CET [2020/03/15 13:51:14 ET]
Table 'Arneb' 6-max Seat #1 is the button
Seat 1: crismatil (€2.06 in chips)
Seat 2: Jagf0010 (€4.95 in chips)
Seat 3: XXXMJA (€3.45 in chips)
Seat 4: DNooXLvv (€3.39 in chips)
Seat 5: girao7 (€3.73 in chips)
Seat 6: Luckers712 (€2.06 in chips)
Jagf0010: posts small blind €0.01
XXXMJA: posts big blind €0.02
*** HOLE CARDS ***
Dealt to Luckers712 [Ah Qs]
DNooXLvv: folds
girao7: raises €0.02 to €0.04
Luckers712: calls €0.04
crismatil: folds
Jagf0010: raises €0.20 to €0.24
XXXMJA: folds
girao7: raises €0.20 to €0.44
Luckers712: raises €1.62 to €2.06 and is all-in
Jagf0010: folds
girao7: calls €1.62
*** FLOP *** [5d 8h 4s]
*** TURN *** [5d 8h 4s] [Kc]
*** RIVER *** [5d 8h 4s Kc] [5s]
*** SHOW DOWN ***
girao7: shows [Kd Td] (two pair, Kings and Fives)
Luckers712: shows [Ah Qs] (a pair of Fives)
girao7 collected €4.16 from pot
*** SUMMARY ***
Total pot €4.38 | Rake €0.22
Board [5d 8h 4s Kc 5s]
Seat 1: crismatil (button) folded before Flop (didn't bet)
Seat 2: Jagf0010 (small blind) folded before Flop
Seat 3: XXXMJA (big blind) folded before Flop
Seat 4: DNooXLvv folded before Flop (didn't bet)
Seat 5: girao7 showed [Kd Td] and won (€4.16) with two pair, Kings and Fives
Seat 6: Luckers712 showed [Ah Qs] and lost with a pair of Fives



PokerStars Zoom Hand #210167794339:  Hold'em No Limit (€0.01/€0.02) - 2020/03/15 18:52:14 CET [2020/03/15 13:52:14 ET]
Table 'Arneb' 6-max Seat #1 is the button
Seat 1: Luckers712 (€2 in chips)
Seat 2: dipibo7 (€2.23 in chips)
Seat 3: eslavoneslavon (€1.06 in chips)
Seat 4: Uribe777 (€1.86 in chips)
Seat 5: carlosmg410 (€2.13 in chips)
Seat 6: DNooXLvv (€2.58 in chips)
dipibo7: posts small blind €0.01
eslavoneslavon: posts big blind €0.02
*** HOLE CARDS ***
Dealt to Luckers712 [2s 5s]
Uribe777: folds
carlosmg410: folds
DNooXLvv: raises €0.04 to €0.06
Luckers712: calls €0.06
dipibo7: folds
eslavoneslavon: calls €0.04
*** FLOP *** [2d Qh Kh]
eslavoneslavon: checks
DNooXLvv: bets €0.05
Luckers712: folds
eslavoneslavon: folds
Uncalled bet (€0.05) returned to DNooXLvv
DNooXLvv collected €0.18 from pot
DNooXLvv: doesn't show hand
*** SUMMARY ***
Total pot €0.19 | Rake €0.01
Board [2d Qh Kh]
Seat 1: Luckers712 (button) folded on the Flop
Seat 2: dipibo7 (small blind) folded before Flop
Seat 3: eslavoneslavon (big blind) folded on the Flop
Seat 4: Uribe777 folded before Flop (didn't bet)
Seat 5: carlosmg410 folded before Flop (didn't bet)
Seat 6: DNooXLvv collected (€0.18)



PokerStars Zoom Hand #210167808149:  Hold'em No Limit (€0.01/€0.02) - 2020/03/15 18:52:29 CET [2020/03/15 13:52:29 ET]
Table 'Arneb' 6-max Seat #1 is the button
Seat 1: Vitorero (€2.77 in chips)
Seat 2: Luckers712 (€1.94 in chips)
Seat 3: javiondo1993 (€2 in chips)
Seat 4: Anaheras (€2.01 in chips)
Seat 5: XXXMJA (€2 in chips)
Seat 6: sajoti (€1.49 in chips)
Luckers712: posts small blind €0.01
javiondo1993: posts big blind €0.02
*** HOLE CARDS ***
Dealt to Luckers712 [Jd Kh]
Anaheras: folds
XXXMJA: folds
sajoti: folds
Vitorero: folds
Luckers712: raises €0.04 to €0.06
javiondo1993: calls €0.04
*** FLOP *** [Qd 7d 5c]
Luckers712: checks
javiondo1993: bets €0.02
Luckers712: calls €0.02
*** TURN *** [Qd 7d 5c] [Qh]
Luckers712: checks
javiondo1993: checks
*** RIVER *** [Qd 7d 5c Qh] [Td]
Luckers712: checks
javiondo1993: bets €0.02
Luckers712: calls €0.02
*** SHOW DOWN ***
javiondo1993: shows [Tc 9s] (two pair, Queens and Tens)
Luckers712: mucks hand
javiondo1993 collected €0.19 from pot
*** SUMMARY ***
Total pot €0.20 | Rake €0.01
Board [Qd 7d 5c Qh Td]
Seat 1: Vitorero (button) folded before Flop (didn't bet)
Seat 2: Luckers712 (small blind) mucked [Jd Kh]
Seat 3: javiondo1993 (big blind) showed [Tc 9s] and won (€0.19) with two pair, Queens and Tens
Seat 4: Anaheras folded before Flop (didn't bet)
Seat 5: XXXMJA folded before Flop (didn't bet)
Seat 6: sajoti folded before Flop (didn't bet)



PokerStars Zoom Hand #210167883135:  Hold'em No Limit (€0.01/€0.02) - 2020/03/15 18:53:48 CET [2020/03/15 13:53:48 ET]
Table 'Arneb' 6-max Seat #1 is the button
Seat 1: slaton (€1.89 in chips)
Seat 2: aportiquevoy (€1.98 in chips)
Seat 3: Kivoila (€0.77 in chips)
Seat 4: pastra352 (€2.01 in chips)
Seat 5: Luckers712 (€1.90 in chips)
Seat 6: vatol0co (€1.77 in chips)
aportiquevoy: posts small blind €0.01
Kivoila: posts big blind €0.02
*** HOLE CARDS ***
Dealt to Luckers712 [3c 9s]
pastra352: folds
Luckers712: folds
vatol0co: folds
slaton: folds
aportiquevoy: folds
Uncalled bet (€0.01) returned to Kivoila
Kivoila collected €0.02 from pot
Kivoila: doesn't show hand
*** SUMMARY ***
Total pot €0.02 | Rake €0
Seat 1: slaton (button) folded before Flop (didn't bet)
Seat 2: aportiquevoy (small blind) folded before Flop
Seat 3: Kivoila (big blind) collected (€0.02)
Seat 4: pastra352 folded before Flop (didn't bet)
Seat 5: Luckers712 folded before Flop (didn't bet)
Seat 6: vatol0co folded before Flop (didn't bet)



PokerStars Zoom Hand #210167888677:  Hold'em No Limit (€0.01/€0.02) - 2020/03/15 18:53:54 CET [2020/03/15 13:53:54 ET]
Table 'Arneb' 6-max Seat #1 is the button
Seat 1: ricmp (€4.43 in chips)
Seat 2: Redbox615 (€2.12 in chips)
Seat 3: Luckers712 (€2 in chips)
Seat 4: RuiGaspar11 (€2.09 in chips)
Seat 5: jparrasa (€2.13 in chips)
Seat 6: The dead97 (€2.95 in chips)
Redbox615: posts small blind €0.01
Luckers712: posts big blind €0.02
*** HOLE CARDS ***
Dealt to Luckers712 [Kc Qd]
RuiGaspar11: raises €0.05 to €0.07
jparrasa: folds
The dead97: folds
ricmp: folds
Redbox615: folds
Luckers712: calls €0.05
*** FLOP *** [9h 8s Jc]
Luckers712: checks
RuiGaspar11: bets €0.18
Luckers712: calls €0.18
*** TURN *** [9h 8s Jc] [5c]
Luckers712: checks
RuiGaspar11: bets €1.84 and is all-in
Luckers712: folds
Uncalled bet (€1.84) returned to RuiGaspar11
RuiGaspar11 collected €0.48 from pot
*** SUMMARY ***
Total pot €0.51 | Rake €0.03
Board [9h 8s Jc 5c]
Seat 1: ricmp (button) folded before Flop (didn't bet)
Seat 2: Redbox615 (small blind) folded before Flop
Seat 3: Luckers712 (big blind) folded on the Turn
Seat 4: RuiGaspar11 collected (€0.48)
Seat 5: jparrasa folded before Flop (didn't bet)
Seat 6: The dead97 folded before Flop (didn't bet)



PokerStars Zoom Hand #210167920150:  Hold'em No Limit (€0.01/€0.02) - 2020/03/15 18:54:28 CET [2020/03/15 13:54:28 ET]
Table 'Arneb' 6-max Seat #1 is the button
Seat 1: XXXMJA (€2 in chips)
Seat 2: chapa1010 (€4.99 in chips)
Seat 3: Pereira1959 (€3.36 in chips)
Seat 4: Luckers712 (€1.75 in chips)
Seat 5: Veesile (€2 in chips)
Seat 6: TJDasNeves (€1.97 in chips)
chapa1010: posts small blind €0.01
Pereira1959: posts big blind €0.02
*** HOLE CARDS ***
Dealt to Luckers712 [6s Ac]
Luckers712: folds
Veesile: folds
TJDasNeves: folds
XXXMJA: folds
chapa1010: folds
Uncalled bet (€0.01) returned to Pereira1959
Pereira1959 collected €0.02 from pot
Pereira1959: doesn't show hand
*** SUMMARY ***
Total pot €0.02 | Rake €0
Seat 1: XXXMJA (button) folded before Flop (didn't bet)
Seat 2: chapa1010 (small blind) folded before Flop
Seat 3: Pereira1959 (big blind) collected (€0.02)
Seat 4: Luckers712 folded before Flop (didn't bet)
Seat 5: Veesile folded before Flop (didn't bet)
Seat 6: TJDasNeves folded before Flop (didn't bet)



PokerStars Zoom Hand #210167924738:  Hold'em No Limit (€0.01/€0.02) - 2020/03/15 18:54:33 CET [2020/03/15 13:54:33 ET]
Table 'Arneb' 6-max Seat #1 is the button
Seat 1: Torcador (€1.46 in chips)
Seat 2: ERIZOCACHO (€6.43 in chips)
Seat 3: crismatil (€3.89 in chips)
Seat 4: Luckers712 (€2 in chips)
Seat 5: dipibo7 (€2.56 in chips)
Seat 6: Kayfidze (€2 in chips)
ERIZOCACHO: posts small blind €0.01
crismatil: posts big blind €0.02
*** HOLE CARDS ***
Dealt to Luckers712 [Th 4s]
Luckers712: folds
dipibo7: raises €0.04 to €0.06
Kayfidze: folds
Torcador: folds
ERIZOCACHO: folds
crismatil: folds
Uncalled bet (€0.04) returned to dipibo7
dipibo7 collected €0.05 from pot
dipibo7: doesn't show hand
*** SUMMARY ***
Total pot €0.05 | Rake €0
Seat 1: Torcador (button) folded before Flop (didn't bet)
Seat 2: ERIZOCACHO (small blind) folded before Flop
Seat 3: crismatil (big blind) folded before Flop
Seat 4: Luckers712 folded before Flop (didn't bet)
Seat 5: dipibo7 collected (€0.05)
Seat 6: Kayfidze folded before Flop (didn't bet)



PokerStars Zoom Hand #210167932126:  Hold'em No Limit (€0.01/€0.02) - 2020/03/15 18:54:41 CET [2020/03/15 13:54:41 ET]
Table 'Arneb' 6-max Seat #1 is the button
Seat 1: Luckers712 (€2 in chips)
Seat 2: Kayfidze (€2 in chips)
Seat 3: pastra352 (€2.23 in chips)
Seat 4: mousepro9 (€4.40 in chips)
Seat 5: Redbox615 (€2.12 in chips)
Seat 6: Starmotion22 (€1.39 in chips)
Kayfidze: posts small blind €0.01
pastra352: posts big blind €0.02
*** HOLE CARDS ***
Dealt to Luckers712 [6s 7d]
mousepro9: folds
Redbox615: folds
Starmotion22: folds
Luckers712: folds
Kayfidze: raises €0.05 to €0.07
pastra352: folds
Uncalled bet (€0.05) returned to Kayfidze
Kayfidze collected €0.04 from pot
Kayfidze: doesn't show hand
*** SUMMARY ***
Total pot €0.04 | Rake €0
Seat 1: Luckers712 (button) folded before Flop (didn't bet)
Seat 2: Kayfidze (small blind) collected (€0.04)
Seat 3: pastra352 (big blind) folded before Flop
Seat 4: mousepro9 folded before Flop (didn't bet)
Seat 5: Redbox615 folded before Flop (didn't bet)
Seat 6: Starmotion22 folded before Flop (didn't bet)



PokerStars Zoom Hand #210167944243:  Hold'em No Limit (€0.01/€0.02) - 2020/03/15 18:54:54 CET [2020/03/15 13:54:54 ET]
Table 'Arneb' 6-max Seat #1 is the button
Seat 1: isildur5793 (€3.51 in chips)
Seat 2: perolete66 (€3.89 in chips)
Seat 3: Starmotion22 (€1.39 in chips)
Seat 4: ellen rypley (€0.84 in chips)
Seat 5: NanoLMP (€2.41 in chips)
Seat 6: Luckers712 (€1.99 in chips)
perolete66: posts small blind €0.01
Starmotion22: posts big blind €0.02
*** HOLE CARDS ***
Dealt to Luckers712 [6c Ah]
ellen rypley: folds
NanoLMP: folds
Luckers712: raises €0.03 to €0.05
isildur5793: folds
perolete66: folds
Starmotion22: folds
Uncalled bet (€0.03) returned to Luckers712
Luckers712 collected €0.05 from pot
Luckers712: doesn't show hand
*** SUMMARY ***
Total pot €0.05 | Rake €0
Seat 1: isildur5793 (button) folded before Flop (didn't bet)
Seat 2: perolete66 (small blind) folded before Flop
Seat 3: Starmotion22 (big blind) folded before Flop
Seat 4: ellen rypley folded before Flop (didn't bet)
Seat 5: NanoLMP folded before Flop (didn't bet)
Seat 6: Luckers712 collected (€0.05)



PokerStars Zoom Hand #210167939520:  Hold'em No Limit (€0.01/€0.02) - 2020/03/15 18:54:49 CET [2020/03/15 13:54:49 ET]
Table 'Arneb' 6-max Seat #1 is the button
Seat 1: KLOSDUFAN (€1.99 in chips)
Seat 2: Luckers712 (€2 in chips)
Seat 3: Lbrt911 (€1 in chips)
Seat 4: chiwas12 (€2.10 in chips)
Seat 5: XXXMJA (€3.89 in chips)
Seat 6: pandemon (€1.57 in chips)
Luckers712: posts small blind €0.01
Lbrt911: posts big blind €0.02
*** HOLE CARDS ***
Dealt to Luckers712 [7d Ks]
chiwas12: raises €0.04 to €0.06
XXXMJA: folds
pandemon: calls €0.06
KLOSDUFAN: folds
Luckers712: folds
Lbrt911: folds
*** FLOP *** [9d 6s Ts]
chiwas12: checks
pandemon: checks
*** TURN *** [9d 6s Ts] [Jh]
chiwas12: checks
pandemon: checks
*** RIVER *** [9d 6s Ts Jh] [Ac]
chiwas12: checks
pandemon: checks
*** SHOW DOWN ***
chiwas12: shows [5d 5s] (a pair of Fives)
pandemon: shows [9h 7h] (a pair of Nines)
pandemon collected €0.14 from pot
*** SUMMARY ***
Total pot €0.15 | Rake €0.01
Board [9d 6s Ts Jh Ac]
Seat 1: KLOSDUFAN (button) folded before Flop (didn't bet)
Seat 2: Luckers712 (small blind) folded before Flop
Seat 3: Lbrt911 (big blind) folded before Flop
Seat 4: chiwas12 showed [5d 5s] and lost with a pair of Fives
Seat 5: XXXMJA folded before Flop (didn't bet)
Seat 6: pandemon showed [9h 7h] and won (€0.14) with a pair of Nines



PokerStars Zoom Hand #210167963394:  Hold'em No Limit (€0.01/€0.02) - 2020/03/15 18:55:06 CET [2020/03/15 13:55:06 ET]
Table 'Arneb' 6-max Seat #1 is the button
Seat 1: TJDasNeves (€1.96 in chips)
Seat 2: estevi_79 (€3.14 in chips)
Seat 3: PITI1231 (€7.50 in chips)
Seat 4: P77100 (€1.50 in chips)
Seat 5: Luckers712 (€2.02 in chips)
Seat 6: 9gef7 (€1.70 in chips)
estevi_79: posts small blind €0.01
PITI1231: posts big blind €0.02
*** HOLE CARDS ***
Dealt to Luckers712 [Jh 6c]
P77100: calls €0.02
Luckers712: folds
9gef7: folds
TJDasNeves: folds
estevi_79: folds
PITI1231: checks
*** FLOP *** [Th 9h 9d]
PITI1231: checks
P77100: checks
*** TURN *** [Th 9h 9d] [5d]
PITI1231: checks
P77100: checks
*** RIVER *** [Th 9h 9d 5d] [9c]
PITI1231: checks
P77100: checks
*** SHOW DOWN ***
PITI1231: shows [4s Kh] (three of a kind, Nines)
P77100: shows [Qc Kd] (three of a kind, Nines - King+Queen kicker)
P77100 collected €0.05 from pot
*** SUMMARY ***
Total pot €0.05 | Rake €0
Board [Th 9h 9d 5d 9c]
Seat 1: TJDasNeves (button) folded before Flop (didn't bet)
Seat 2: estevi_79 (small blind) folded before Flop
Seat 3: PITI1231 (big blind) showed [4s Kh] and lost with three of a kind, Nines
Seat 4: P77100 showed [Qc Kd] and won (€0.05) with three of a kind, Nines
Seat 5: Luckers712 folded before Flop (didn't bet)
Seat 6: 9gef7 folded before Flop (didn't bet)



PokerStars Zoom Hand #210168001589:  Hold'em No Limit (€0.01/€0.02) - 2020/03/15 18:56:03 CET [2020/03/15 13:56:03 ET]
Table 'Arneb' 6-max Seat #1 is the button
Seat 1: FocusBuilder (€2 in chips)
Seat 2: toniton888 (€1.05 in chips)
Seat 3: Luckers712 (€2.02 in chips)
Seat 4: cañon000 (€1.98 in chips)
Seat 5: tresiño (€1.18 in chips)
Seat 6: Cangrejocotyx (€0.47 in chips)
toniton888: posts small blind €0.01
Luckers712: posts big blind €0.02
*** HOLE CARDS ***
Dealt to Luckers712 [4d 8d]
cañon000: raises €0.02 to €0.04
tresiño: folds
Cangrejocotyx: folds
FocusBuilder: folds
toniton888: folds
Luckers712: raises €0.08 to €0.12
cañon000: calls €0.08
*** FLOP *** [4c 9h Ah]
Luckers712: checks
cañon000: bets €0.24
Luckers712: calls €0.24
*** TURN *** [4c 9h Ah] [Qh]
Luckers712: checks
cañon000: checks
*** RIVER *** [4c 9h Ah Qh] [Th]
Luckers712: bets €0.20
cañon000: folds
Uncalled bet (€0.20) returned to Luckers712
Luckers712 collected €0.69 from pot
Luckers712: doesn't show hand
*** SUMMARY ***
Total pot €0.73 | Rake €0.04
Board [4c 9h Ah Qh Th]
Seat 1: FocusBuilder (button) folded before Flop (didn't bet)
Seat 2: toniton888 (small blind) folded before Flop
Seat 3: Luckers712 (big blind) collected (€0.69)
Seat 4: cañon000 folded on the River
Seat 5: tresiño folded before Flop (didn't bet)
Seat 6: Cangrejocotyx folded before Flop (didn't bet)



PokerStars Zoom Hand #210168038962:  Hold'em No Limit (€0.01/€0.02) - 2020/03/15 18:57:04 CET [2020/03/15 13:57:04 ET]
Table 'Arneb' 6-max Seat #1 is the button
Seat 1: Capitan Aab (€2.41 in chips)
Seat 2: Luckers712 (€2.35 in chips)
Seat 3: TJDasNeves (€1.99 in chips)
Seat 4: The dead97 (€4.69 in chips)
Seat 5: belcebubu (€1.46 in chips)
Seat 6: ciclo230385 (€6.34 in chips)
Luckers712: posts small blind €0.01
TJDasNeves: posts big blind €0.02
*** HOLE CARDS ***
Dealt to Luckers712 [3c 5c]
The dead97: folds
belcebubu: folds
ciclo230385: folds
Capitan Aab: folds
Luckers712: raises €0.04 to €0.06
TJDasNeves: folds
Uncalled bet (€0.04) returned to Luckers712
Luckers712 collected €0.04 from pot
Luckers712: doesn't show hand
*** SUMMARY ***
Total pot €0.04 | Rake €0
Seat 1: Capitan Aab (button) folded before Flop (didn't bet)
Seat 2: Luckers712 (small blind) collected (€0.04)
Seat 3: TJDasNeves (big blind) folded before Flop
Seat 4: The dead97 folded before Flop (didn't bet)
Seat 5: belcebubu folded before Flop (didn't bet)
Seat 6: ciclo230385 folded before Flop (didn't bet)



PokerStars Zoom Hand #210168046920:  Hold'em No Limit (€0.01/€0.02) - 2020/03/15 18:57:17 CET [2020/03/15 13:57:17 ET]
Table 'Arneb' 6-max Seat #1 is the button
Seat 1: Luckers712 (€2.37 in chips)
Seat 2: Miltonmoreno (€2.23 in chips)
Seat 3: o1o0o1o (€2 in chips)
Seat 4: unounoporfavor (€2 in chips)
Seat 5: 0226BCR (€0.55 in chips)
Seat 6: Jouse69 (€2.57 in chips)
Miltonmoreno: posts small blind €0.01
o1o0o1o: posts big blind €0.02
*** HOLE CARDS ***
Dealt to Luckers712 [8c 6h]
unounoporfavor: folds
0226BCR: folds
Jouse69: folds
Luckers712: raises €0.03 to €0.05
Miltonmoreno: folds
o1o0o1o: folds
Uncalled bet (€0.03) returned to Luckers712
Luckers712 collected €0.05 from pot
Luckers712: doesn't show hand
*** SUMMARY ***
Total pot €0.05 | Rake €0
Seat 1: Luckers712 (button) collected (€0.05)
Seat 2: Miltonmoreno (small blind) folded before Flop
Seat 3: o1o0o1o (big blind) folded before Flop
Seat 4: unounoporfavor folded before Flop (didn't bet)
Seat 5: 0226BCR folded before Flop (didn't bet)
Seat 6: Jouse69 folded before Flop (didn't bet)



PokerStars Zoom Hand #210168036407:  Hold'em No Limit (€0.01/€0.02) - 2020/03/15 18:57:00 CET [2020/03/15 13:57:00 ET]
Table 'Arneb' 6-max Seat #1 is the button
Seat 1: DNooXLvv (€2.13 in chips)
Seat 2: Miltonmoreno (€2.85 in chips)
Seat 3: MigDmaria (€2.05 in chips)
Seat 4: garza2610 (€1.62 in chips)
Seat 5: Luckers712 (€2.35 in chips)
Seat 6: juantiogot (€4.39 in chips)
Miltonmoreno: posts small blind €0.01
MigDmaria: posts big blind €0.02
*** HOLE CARDS ***
Dealt to Luckers712 [3c Ks]
garza2610: calls €0.02
Luckers712: folds
juantiogot: folds
DNooXLvv: raises €0.05 to €0.07
Miltonmoreno: calls €0.06
MigDmaria: folds
garza2610: calls €0.05
*** FLOP *** [7d Ac 9h]
Miltonmoreno: checks
garza2610: checks
DNooXLvv: bets €0.06
Miltonmoreno: folds
garza2610: calls €0.06
*** TURN *** [7d Ac 9h] [Qd]
garza2610: checks
DNooXLvv: bets €0.42
garza2610: folds
Uncalled bet (€0.42) returned to DNooXLvv
DNooXLvv collected €0.33 from pot
DNooXLvv: doesn't show hand
*** SUMMARY ***
Total pot €0.35 | Rake €0.02
Board [7d Ac 9h Qd]
Seat 1: DNooXLvv (button) collected (€0.33)
Seat 2: Miltonmoreno (small blind) folded on the Flop
Seat 3: MigDmaria (big blind) folded before Flop
Seat 4: garza2610 folded on the Turn
Seat 5: Luckers712 folded before Flop (didn't bet)
Seat 6: juantiogot folded before Flop (didn't bet)



PokerStars Zoom Hand #210168058847:  Hold'em No Limit (€0.01/€0.02) - 2020/03/15 18:57:36 CET [2020/03/15 13:57:36 ET]
Table 'Arneb' 6-max Seat #1 is the button
Seat 1: mousepro9 (€2.02 in chips)
Seat 2: pastra352 (€2.34 in chips)
Seat 3: Jouse69 (€2.56 in chips)
Seat 4: manogarci (€1.42 in chips)
Seat 5: mounty22333 (€1.46 in chips)
Seat 6: Luckers712 (€2.40 in chips)
pastra352: posts small blind €0.01
Jouse69: posts big blind €0.02
*** HOLE CARDS ***
Dealt to Luckers712 [Qd 3h]
manogarci: folds
mounty22333: folds
Luckers712: folds
mousepro9: folds
pastra352: folds
Uncalled bet (€0.01) returned to Jouse69
Jouse69 collected €0.02 from pot
Jouse69: doesn't show hand
*** SUMMARY ***
Total pot €0.02 | Rake €0
Seat 1: mousepro9 (button) folded before Flop (didn't bet)
Seat 2: pastra352 (small blind) folded before Flop
Seat 3: Jouse69 (big blind) collected (€0.02)
Seat 4: manogarci folded before Flop (didn't bet)
Seat 5: mounty22333 folded before Flop (didn't bet)
Seat 6: Luckers712 folded before Flop (didn't bet)



PokerStars Zoom Hand #210168062479:  Hold'em No Limit (€0.01/€0.02) - 2020/03/15 18:57:42 CET [2020/03/15 13:57:42 ET]
Table 'Arneb' 6-max Seat #1 is the button
Seat 1: XXXMJA (€3.83 in chips)
Seat 2: o1o0o1o (€3.75 in chips)
Seat 3: Luckers712 (€2.40 in chips)
Seat 4: estevi_79 (€1.99 in chips)
Seat 5: pandemon (€1.57 in chips)
Seat 6: albertito151 (€2.13 in chips)
o1o0o1o: posts small blind €0.01
Luckers712: posts big blind €0.02
*** HOLE CARDS ***
Dealt to Luckers712 [4d 2d]
estevi_79: folds
pandemon: raises €0.04 to €0.06
albertito151: folds
XXXMJA: folds
o1o0o1o: calls €0.05
Luckers712: folds
*** FLOP *** [3c 7d 5c]
o1o0o1o: checks
pandemon: bets €0.10
o1o0o1o: folds
Uncalled bet (€0.10) returned to pandemon
pandemon collected €0.13 from pot
pandemon: doesn't show hand
*** SUMMARY ***
Total pot €0.14 | Rake €0.01
Board [3c 7d 5c]
Seat 1: XXXMJA (button) folded before Flop (didn't bet)
Seat 2: o1o0o1o (small blind) folded on the Flop
Seat 3: Luckers712 (big blind) folded before Flop
Seat 4: estevi_79 folded before Flop (didn't bet)
Seat 5: pandemon collected (€0.13)
Seat 6: albertito151 folded before Flop (didn't bet)



PokerStars Zoom Hand #210168081808:  Hold'em No Limit (€0.01/€0.02) - 2020/03/15 18:58:13 CET [2020/03/15 13:58:13 ET]
Table 'Arneb' 6-max Seat #1 is the button
Seat 1: CrisR98 (€0.76 in chips)
Seat 2: aportiquevoy (€1.97 in chips)
Seat 3: Dieguiiño_NL (€0.64 in chips)
Seat 4: Luckers712 (€2.38 in chips)
Seat 5: Kayfidze (€2.02 in chips)
Seat 6: perolete66 (€2.29 in chips)
aportiquevoy: posts small blind €0.01
Dieguiiño_NL: posts big blind €0.02
*** HOLE CARDS ***
Dealt to Luckers712 [5d Th]
Luckers712: folds
Kayfidze: folds
perolete66: raises €0.03 to €0.05
CrisR98: folds
aportiquevoy: raises €0.12 to €0.17
Dieguiiño_NL: folds
perolete66: folds
Uncalled bet (€0.12) returned to aportiquevoy
aportiquevoy collected €0.12 from pot
aportiquevoy: doesn't show hand
*** SUMMARY ***
Total pot €0.12 | Rake €0
Seat 1: CrisR98 (button) folded before Flop (didn't bet)
Seat 2: aportiquevoy (small blind) collected (€0.12)
Seat 3: Dieguiiño_NL (big blind) folded before Flop
Seat 4: Luckers712 folded before Flop (didn't bet)
Seat 5: Kayfidze folded before Flop (didn't bet)
Seat 6: perolete66 folded before Flop



PokerStars Zoom Hand #210168084238:  Hold'em No Limit (€0.01/€0.02) - 2020/03/15 18:58:17 CET [2020/03/15 13:58:17 ET]
Table 'Arneb' 6-max Seat #1 is the button
Seat 1: Luckers712 (€2.38 in chips)
Seat 2: Veesile (€2 in chips)
Seat 3: alfanetworka (€2.03 in chips)
Seat 4: Nexlys (€4.09 in chips)
Seat 5: o1o0o1o (€3.69 in chips)
Seat 6: lusto09 (€2.06 in chips)
Veesile: posts small blind €0.01
alfanetworka: posts big blind €0.02
*** HOLE CARDS ***
Dealt to Luckers712 [7h Qs]
Nexlys: folds
o1o0o1o: folds
lusto09: folds
Luckers712: raises €0.03 to €0.05
Veesile: folds
alfanetworka: calls €0.03
*** FLOP *** [7c As 6c]
alfanetworka: checks
Luckers712: bets €0.05
alfanetworka: folds
Uncalled bet (€0.05) returned to Luckers712
Luckers712 collected €0.10 from pot
Luckers712: doesn't show hand
*** SUMMARY ***
Total pot €0.11 | Rake €0.01
Board [7c As 6c]
Seat 1: Luckers712 (button) collected (€0.10)
Seat 2: Veesile (small blind) folded before Flop
Seat 3: alfanetworka (big blind) folded on the Flop
Seat 4: Nexlys folded before Flop (didn't bet)
Seat 5: o1o0o1o folded before Flop (didn't bet)
Seat 6: lusto09 folded before Flop (didn't bet)



PokerStars Zoom Hand #210168101618:  Hold'em No Limit (€0.01/€0.02) - 2020/03/15 18:58:45 CET [2020/03/15 13:58:45 ET]
Table 'Arneb' 6-max Seat #1 is the button
Seat 1: bandittours (€2.29 in chips)
Seat 2: Luckers712 (€2.43 in chips)
Seat 3: PatrickVence (€3.11 in chips)
Seat 4: CLIORANGE (€3.56 in chips)
Seat 5: bilboubou78 (€2.97 in chips)
Seat 6: Lbrt911 (€1.02 in chips)
Luckers712: posts small blind €0.01
PatrickVence: posts big blind €0.02
*** HOLE CARDS ***
Dealt to Luckers712 [Th Jc]
CLIORANGE: folds
bilboubou78: folds
Lbrt911: raises €0.04 to €0.06
bandittours: folds
Luckers712: folds
PatrickVence: folds
Uncalled bet (€0.04) returned to Lbrt911
Lbrt911 collected €0.05 from pot
Lbrt911: doesn't show hand
*** SUMMARY ***
Total pot €0.05 | Rake €0
Seat 1: bandittours (button) folded before Flop (didn't bet)
Seat 2: Luckers712 (small blind) folded before Flop
Seat 3: PatrickVence (big blind) folded before Flop
Seat 4: CLIORANGE folded before Flop (didn't bet)
Seat 5: bilboubou78 folded before Flop (didn't bet)
Seat 6: Lbrt911 collected (€0.05)



PokerStars Zoom Hand #210168116117:  Hold'em No Limit (€0.01/€0.02) - 2020/03/15 18:59:08 CET [2020/03/15 13:59:08 ET]
Table 'Arneb' 6-max Seat #1 is the button
Seat 1: Capitan Aab (€2.03 in chips)
Seat 2: alestoral (€1.47 in chips)
Seat 3: R1p-j (€1.02 in chips)
Seat 4: Romevk (€4.59 in chips)
Seat 5: Luckers712 (€2.42 in chips)
Seat 6: jzamora2011 (€5.57 in chips)
alestoral: posts small blind €0.01
R1p-j: posts big blind €0.02
*** HOLE CARDS ***
Dealt to Luckers712 [7d 2c]
Romevk: folds
Luckers712: folds
jzamora2011: folds
Capitan Aab: folds
alestoral: folds
Uncalled bet (€0.01) returned to R1p-j
R1p-j collected €0.02 from pot
R1p-j: doesn't show hand
*** SUMMARY ***
Total pot €0.02 | Rake €0
Seat 1: Capitan Aab (button) folded before Flop (didn't bet)
Seat 2: alestoral (small blind) folded before Flop
Seat 3: R1p-j (big blind) collected (€0.02)
Seat 4: Romevk folded before Flop (didn't bet)
Seat 5: Luckers712 folded before Flop (didn't bet)
Seat 6: jzamora2011 folded before Flop (didn't bet)



PokerStars Zoom Hand #210168120606:  Hold'em No Limit (€0.01/€0.02) - 2020/03/15 18:59:15 CET [2020/03/15 13:59:15 ET]
Table 'Arneb' 6-max Seat #1 is the button
Seat 1: aportiquevoy (€2.49 in chips)
Seat 2: Miltonmoreno (€1.47 in chips)
Seat 3: Luckers712 (€2.42 in chips)
Seat 4: Dark_make632 (€2.03 in chips)
Seat 5: JMB1893 (€2.58 in chips)
Seat 6: The dead97 (€4.61 in chips)
Miltonmoreno: posts small blind €0.01
Luckers712: posts big blind €0.02
*** HOLE CARDS ***
Dealt to Luckers712 [2h Kc]
Dark_make632: folds
JMB1893: folds
The dead97: folds
aportiquevoy: folds
Miltonmoreno: calls €0.01
Luckers712: checks
*** FLOP *** [5d 5s Ah]
Miltonmoreno: checks
Luckers712: checks
*** TURN *** [5d 5s Ah] [2s]
Miltonmoreno: checks
Luckers712: checks
*** RIVER *** [5d 5s Ah 2s] [Js]
Miltonmoreno: checks
Luckers712: checks
*** SHOW DOWN ***
Miltonmoreno: shows [2c Qh] (two pair, Fives and Deuces)
Luckers712: shows [2h Kc] (two pair, Fives and Deuces)
Miltonmoreno collected €0.02 from pot
Luckers712 collected €0.02 from pot
*** SUMMARY ***
Total pot €0.04 | Rake €0
Board [5d 5s Ah 2s Js]
Seat 1: aportiquevoy (button) folded before Flop (didn't bet)
Seat 2: Miltonmoreno (small blind) showed [2c Qh] and won (€0.02) with two pair, Fives and Deuces
Seat 3: Luckers712 (big blind) showed [2h Kc] and won (€0.02) with two pair, Fives and Deuces
Seat 4: Dark_make632 folded before Flop (didn't bet)
Seat 5: JMB1893 folded before Flop (didn't bet)
Seat 6: The dead97 folded before Flop (didn't bet)



PokerStars Zoom Hand #210168138243:  Hold'em No Limit (€0.01/€0.02) - 2020/03/15 18:59:42 CET [2020/03/15 13:59:42 ET]
Table 'Arneb' 6-max Seat #1 is the button
Seat 1: fcruz91 (€2.60 in chips)
Seat 2: Kayfidze (€2 in chips)
Seat 3: Vitibou (€1.56 in chips)
Seat 4: cusebre (€2.11 in chips)
Seat 5: manogarci (€1.26 in chips)
Seat 6: Luckers712 (€2.42 in chips)
Kayfidze: posts small blind €0.01
Vitibou: posts big blind €0.02
*** HOLE CARDS ***
Dealt to Luckers712 [6h 7s]
cusebre: folds
manogarci: folds
Luckers712: folds
fcruz91: raises €0.04 to €0.06
Kayfidze: folds
Vitibou: folds
Uncalled bet (€0.04) returned to fcruz91
fcruz91 collected €0.05 from pot
fcruz91: doesn't show hand
*** SUMMARY ***
Total pot €0.05 | Rake €0
Seat 1: fcruz91 (button) collected (€0.05)
Seat 2: Kayfidze (small blind) folded before Flop
Seat 3: Vitibou (big blind) folded before Flop
Seat 4: cusebre folded before Flop (didn't bet)
Seat 5: manogarci folded before Flop (didn't bet)
Seat 6: Luckers712 folded before Flop (didn't bet)



PokerStars Zoom Hand #210168112968:  Hold'em No Limit (€0.01/€0.02) - 2020/03/15 18:59:03 CET [2020/03/15 13:59:03 ET]
Table 'Arneb' 6-max Seat #1 is the button
Seat 1: ThePryce (€1.32 in chips)
Seat 2: RLBmilitary (€4.09 in chips)
Seat 3: JMB1893 (€2.60 in chips)
Seat 4: Capitan Aab (€2.03 in chips)
Seat 5: Chemi270599 (€2.23 in chips)
Seat 6: Luckers712 (€2.42 in chips)
RLBmilitary: posts small blind €0.01
JMB1893: posts big blind €0.02
*** HOLE CARDS ***
Dealt to Luckers712 [4c 3d]
Capitan Aab: folds
Chemi270599: calls €0.02
Luckers712: folds
ThePryce: raises €0.06 to €0.08
RLBmilitary: folds
JMB1893: folds
Chemi270599: calls €0.06
*** FLOP *** [Ah 4h 7d]
Chemi270599: bets €0.06
ThePryce: raises €0.12 to €0.18
Chemi270599: raises €0.12 to €0.30
ThePryce: calls €0.12
*** TURN *** [Ah 4h 7d] [Kh]
Chemi270599: bets €0.06
ThePryce: calls €0.06
*** RIVER *** [Ah 4h 7d Kh] [7c]
Chemi270599: bets €0.16
ThePryce: calls €0.16
*** SHOW DOWN ***
Chemi270599: shows [Ad 4s] (two pair, Aces and Sevens)
ThePryce: shows [Ts Ac] (two pair, Aces and Sevens)
Chemi270599 collected €0.59 from pot
ThePryce collected €0.58 from pot
*** SUMMARY ***
Total pot €1.23 | Rake €0.06
Board [Ah 4h 7d Kh 7c]
Seat 1: ThePryce (button) showed [Ts Ac] and won (€0.58) with two pair, Aces and Sevens
Seat 2: RLBmilitary (small blind) folded before Flop
Seat 3: JMB1893 (big blind) folded before Flop
Seat 4: Capitan Aab folded before Flop (didn't bet)
Seat 5: Chemi270599 showed [Ad 4s] and won (€0.59) with two pair, Aces and Sevens
Seat 6: Luckers712 folded before Flop (didn't bet)



PokerStars Zoom Hand #210168142655:  Hold'em No Limit (€0.01/€0.02) - 2020/03/15 18:59:49 CET [2020/03/15 13:59:49 ET]
Table 'Arneb' 6-max Seat #1 is the button
Seat 1: ToniMarteens (€0.74 in chips)
Seat 2: Luckers712 (€2.42 in chips)
Seat 3: trakson (€2 in chips)
Seat 4: chiwas12 (€2.84 in chips)
Seat 5: RuiGaspar11 (€0.79 in chips)
Seat 6: pastra352 (€2.33 in chips)
Luckers712: posts small blind €0.01
trakson: posts big blind €0.02
*** HOLE CARDS ***
Dealt to Luckers712 [Kc 5d]
chiwas12: folds
RuiGaspar11: raises €0.05 to €0.07
pastra352: folds
ToniMarteens: folds
Luckers712: folds
trakson: folds
Uncalled bet (€0.05) returned to RuiGaspar11
RuiGaspar11 collected €0.05 from pot
RuiGaspar11: doesn't show hand
*** SUMMARY ***
Total pot €0.05 | Rake €0
Seat 1: ToniMarteens (button) folded before Flop (didn't bet)
Seat 2: Luckers712 (small blind) folded before Flop
Seat 3: trakson (big blind) folded before Flop
Seat 4: chiwas12 folded before Flop (didn't bet)
Seat 5: RuiGaspar11 collected (€0.05)
Seat 6: pastra352 folded before Flop (didn't bet)



PokerStars Zoom Hand #210168147139:  Hold'em No Limit (€0.01/€0.02) - 2020/03/15 18:59:56 CET [2020/03/15 13:59:56 ET]
Table 'Arneb' 6-max Seat #1 is the button
Seat 1: Vitibou (€1.54 in chips)
Seat 2: o1o0o1o (€3.64 in chips)
Seat 3: DNooXLvv (€5.25 in chips)
Seat 4: xSirc (€2.82 in chips)
Seat 5: Luckers712 (€2.41 in chips)
Seat 6: Veesile (€4.09 in chips)
o1o0o1o: posts small blind €0.01
DNooXLvv: posts big blind €0.02
*** HOLE CARDS ***
Dealt to Luckers712 [5s Tc]
xSirc: raises €0.04 to €0.06
Luckers712: folds
Veesile: folds
Vitibou: folds
o1o0o1o: folds
DNooXLvv: calls €0.04
*** FLOP *** [Kd 8h 8d]
DNooXLvv: checks
xSirc: checks
*** TURN *** [Kd 8h 8d] [Ts]
DNooXLvv: bets €0.04
xSirc: calls €0.04
*** RIVER *** [Kd 8h 8d Ts] [Ad]
DNooXLvv: checks
xSirc: checks
*** SHOW DOWN ***
DNooXLvv: shows [6s Ks] (two pair, Kings and Eights)
xSirc: mucks hand
DNooXLvv collected €0.20 from pot
*** SUMMARY ***
Total pot €0.21 | Rake €0.01
Board [Kd 8h 8d Ts Ad]
Seat 1: Vitibou (button) folded before Flop (didn't bet)
Seat 2: o1o0o1o (small blind) folded before Flop
Seat 3: DNooXLvv (big blind) showed [6s Ks] and won (€0.20) with two pair, Kings and Eights
Seat 4: xSirc mucked [9h Jh]
Seat 5: Luckers712 folded before Flop (didn't bet)
Seat 6: Veesile folded before Flop (didn't bet)



PokerStars Zoom Hand #210168149682:  Hold'em No Limit (€0.01/€0.02) - 2020/03/15 19:00:00 CET [2020/03/15 14:00:00 ET]
Table 'Arneb' 6-max Seat #1 is the button
Seat 1: Luckers712 (€2.41 in chips)
Seat 2: estevi_79 (€4.23 in chips)
Seat 3: XXXMJA (€2 in chips)
Seat 4: user in orb (€1.89 in chips)
Seat 5: Veesile (€4.09 in chips)
Seat 6: FocusBuilder (€2 in chips)
estevi_79: posts small blind €0.01
XXXMJA: posts big blind €0.02
*** HOLE CARDS ***
Dealt to Luckers712 [3c Ad]
user in orb: folds
Veesile: folds
FocusBuilder: folds
Luckers712: raises €0.03 to €0.05
estevi_79: folds
XXXMJA: folds
Uncalled bet (€0.03) returned to Luckers712
Luckers712 collected €0.05 from pot
Luckers712: doesn't show hand
*** SUMMARY ***
Total pot €0.05 | Rake €0
Seat 1: Luckers712 (button) collected (€0.05)
Seat 2: estevi_79 (small blind) folded before Flop
Seat 3: XXXMJA (big blind) folded before Flop
Seat 4: user in orb folded before Flop (didn't bet)
Seat 5: Veesile folded before Flop (didn't bet)
Seat 6: FocusBuilder folded before Flop (didn't bet)



PokerStars Zoom Hand #210168174294:  Hold'em No Limit (€0.01/€0.02) - 2020/03/15 19:00:36 CET [2020/03/15 14:00:36 ET]
Table 'Arneb' 6-max Seat #1 is the button
Seat 1: Capitan Aab (€2.07 in chips)
Seat 2: ordisile (€2.08 in chips)
Seat 3: Luckers712 (€2.44 in chips)
Seat 4: philoudecaze (€1.97 in chips)
Seat 5: bandittours (€2.21 in chips)
Seat 6: tetar1000d (€2 in chips)
ordisile: posts small blind €0.01
Luckers712: posts big blind €0.02
*** HOLE CARDS ***
Dealt to Luckers712 [8c 7h]
philoudecaze: folds
bandittours: folds
tetar1000d: folds
Capitan Aab: folds
ordisile: raises €0.06 to €0.08
Luckers712: folds
Uncalled bet (€0.06) returned to ordisile
ordisile collected €0.04 from pot
ordisile: doesn't show hand
*** SUMMARY ***
Total pot €0.04 | Rake €0
Seat 1: Capitan Aab (button) folded before Flop (didn't bet)
Seat 2: ordisile (small blind) collected (€0.04)
Seat 3: Luckers712 (big blind) folded before Flop
Seat 4: philoudecaze folded before Flop (didn't bet)
Seat 5: bandittours folded before Flop (didn't bet)
Seat 6: tetar1000d folded before Flop (didn't bet)



PokerStars Zoom Hand #210168166897:  Hold'em No Limit (€0.01/€0.02) - 2020/03/15 19:00:25 CET [2020/03/15 14:00:25 ET]
Table 'Arneb' 6-max Seat #1 is the button
Seat 1: chris8200178 (€1.38 in chips)
Seat 2: mounty22333 (€1.40 in chips)
Seat 3: DNooXLvv (€3.09 in chips)
Seat 4: alfanetworka (€1.70 in chips)
Seat 5: Luckers712 (€2.44 in chips)
Seat 6: frodoh1 (€3.24 in chips)
mounty22333: posts small blind €0.01
DNooXLvv: posts big blind €0.02
*** HOLE CARDS ***
Dealt to Luckers712 [3s Jc]
alfanetworka: calls €0.02
Luckers712: folds
frodoh1: folds
chris8200178: raises €0.06 to €0.08
mounty22333: calls €0.07
DNooXLvv: folds
alfanetworka: calls €0.06
*** FLOP *** [6h 8d 9d]
mounty22333: bets €0.08
alfanetworka: calls €0.08
chris8200178: calls €0.08
*** TURN *** [6h 8d 9d] [3d]
mounty22333: checks
alfanetworka: bets €0.24
chris8200178: folds
mounty22333: folds
Uncalled bet (€0.24) returned to alfanetworka
alfanetworka collected €0.48 from pot
alfanetworka: doesn't show hand
*** SUMMARY ***
Total pot €0.50 | Rake €0.02
Board [6h 8d 9d 3d]
Seat 1: chris8200178 (button) folded on the Turn
Seat 2: mounty22333 (small blind) folded on the Turn
Seat 3: DNooXLvv (big blind) folded before Flop
Seat 4: alfanetworka collected (€0.48)
Seat 5: Luckers712 folded before Flop (didn't bet)
Seat 6: frodoh1 folded before Flop (didn't bet)



PokerStars Zoom Hand #210168187580:  Hold'em No Limit (€0.01/€0.02) - 2020/03/15 19:00:55 CET [2020/03/15 14:00:55 ET]
Table 'Arneb' 6-max Seat #1 is the button
Seat 1: Markitos PT (€2.42 in chips)
Seat 2: Luckers712 (€2.42 in chips)
Seat 3: Galin1312 (€2.18 in chips)
Seat 4: chiwas12 (€2.11 in chips)
Seat 5: MigDmaria (€2.06 in chips)
Seat 6: american909 (€1.83 in chips)
Luckers712: posts small blind €0.01
Galin1312: posts big blind €0.02
*** HOLE CARDS ***
Dealt to Luckers712 [6s Kc]
chiwas12: folds
MigDmaria has timed out
MigDmaria: folds
american909: raises €0.12 to €0.14
Markitos PT: folds
Luckers712: folds
Galin1312: folds
Uncalled bet (€0.12) returned to american909
american909 collected €0.05 from pot
american909: doesn't show hand
*** SUMMARY ***
Total pot €0.05 | Rake €0
Seat 1: Markitos PT (button) folded before Flop (didn't bet)
Seat 2: Luckers712 (small blind) folded before Flop
Seat 3: Galin1312 (big blind) folded before Flop
Seat 4: chiwas12 folded before Flop (didn't bet)
Seat 5: MigDmaria folded before Flop (didn't bet)
Seat 6: american909 collected (€0.05)



PokerStars Zoom Hand #210168228044:  Hold'em No Limit (€0.01/€0.02) - 2020/03/15 19:01:39 CET [2020/03/15 14:01:39 ET]
Table 'Arneb' 6-max Seat #1 is the button
Seat 1: estevi_79 (€2 in chips)
Seat 2: PatrickVence (€3.25 in chips)
Seat 3: Luckers712 (€2.41 in chips)
Seat 4: Séneca Magic (€7.86 in chips)
Seat 5: PITI1231 (€2 in chips)
Seat 6: Comino79 (€1.40 in chips)
PatrickVence: posts small blind €0.01
Luckers712: posts big blind €0.02
*** HOLE CARDS ***
Dealt to Luckers712 [2d Ad]
Séneca Magic: folds
PITI1231: folds
Comino79: folds
estevi_79: folds
PatrickVence: folds
Uncalled bet (€0.01) returned to Luckers712
Luckers712 collected €0.02 from pot
Luckers712: doesn't show hand
*** SUMMARY ***
Total pot €0.02 | Rake €0
Seat 1: estevi_79 (button) folded before Flop (didn't bet)
Seat 2: PatrickVence (small blind) folded before Flop
Seat 3: Luckers712 (big blind) collected (€0.02)
Seat 4: Séneca Magic folded before Flop (didn't bet)
Seat 5: PITI1231 folded before Flop (didn't bet)
Seat 6: Comino79 folded before Flop (didn't bet)



PokerStars Zoom Hand #210168224952:  Hold'em No Limit (€0.01/€0.02) - 2020/03/15 19:01:35 CET [2020/03/15 14:01:35 ET]
Table 'Arneb' 6-max Seat #1 is the button
Seat 1: Dieguiiño_NL (€0.77 in chips)
Seat 2: ~mRG^^54 (€2.14 in chips)
Seat 3: lusto09 (€2.07 in chips)
Seat 4: clapo44980 (€1.13 in chips)
Seat 5: Luckers712 (€2.41 in chips)
Seat 6: frodoh1 (€3.28 in chips)
~mRG^^54: posts small blind €0.01
lusto09: posts big blind €0.02
*** HOLE CARDS ***
Dealt to Luckers712 [Qc 9d]
clapo44980: calls €0.02
Luckers712: folds
frodoh1: folds
Dieguiiño_NL: folds
~mRG^^54: folds
lusto09: checks
*** FLOP *** [8h Jh 7c]
lusto09: checks
clapo44980: checks
*** TURN *** [8h Jh 7c] [Jc]
lusto09: checks
clapo44980: checks
*** RIVER *** [8h Jh 7c Jc] [7d]
lusto09: bets €0.02
clapo44980: calls €0.02
*** SHOW DOWN ***
lusto09: shows [Kh 8s] (two pair, Jacks and Eights)
clapo44980: shows [Th Ts] (two pair, Jacks and Tens)
clapo44980 collected €0.09 from pot
*** SUMMARY ***
Total pot €0.09 | Rake €0
Board [8h Jh 7c Jc 7d]
Seat 1: Dieguiiño_NL (button) folded before Flop (didn't bet)
Seat 2: ~mRG^^54 (small blind) folded before Flop
Seat 3: lusto09 (big blind) showed [Kh 8s] and lost with two pair, Jacks and Eights
Seat 4: clapo44980 showed [Th Ts] and won (€0.09) with two pair, Jacks and Tens
Seat 5: Luckers712 folded before Flop (didn't bet)
Seat 6: frodoh1 folded before Flop (didn't bet)



PokerStars Zoom Hand #210168236699:  Hold'em No Limit (€0.01/€0.02) - 2020/03/15 19:01:50 CET [2020/03/15 14:01:50 ET]
Table 'Arneb' 6-max Seat #1 is the button
Seat 1: ~mRG^^54 (€2.06 in chips)
Seat 2: Luckers712 (€2.42 in chips)
Seat 3: cocololo91 (€6.45 in chips)
Seat 4: Dark_make632 (€2.37 in chips)
Seat 5: lucky13re (€2.62 in chips)
Seat 6: javimagnu (€2.12 in chips)
Luckers712: posts small blind €0.01
cocololo91: posts big blind €0.02
*** HOLE CARDS ***
Dealt to Luckers712 [Th 7s]
Dark_make632: folds
lucky13re: folds
javimagnu: folds
~mRG^^54: folds
Luckers712: folds
Uncalled bet (€0.01) returned to cocololo91
cocololo91 collected €0.02 from pot
cocololo91: doesn't show hand
*** SUMMARY ***
Total pot €0.02 | Rake €0
Seat 1: ~mRG^^54 (button) folded before Flop (didn't bet)
Seat 2: Luckers712 (small blind) folded before Flop
Seat 3: cocololo91 (big blind) collected (€0.02)
Seat 4: Dark_make632 folded before Flop (didn't bet)
Seat 5: lucky13re folded before Flop (didn't bet)
Seat 6: javimagnu folded before Flop (didn't bet)



PokerStars Zoom Hand #210168239801:  Hold'em No Limit (€0.01/€0.02) - 2020/03/15 19:01:54 CET [2020/03/15 14:01:54 ET]
Table 'Arneb' 6-max Seat #1 is the button
Seat 1: Luckers712 (€2.41 in chips)
Seat 2: PatrickVence (€3.24 in chips)
Seat 3: albertito151 (€3.91 in chips)
Seat 4: chiwas12 (€2.10 in chips)
Seat 5: Marlock10 (€1 in chips)
Seat 6: unounoporfavor (€3.86 in chips)
PatrickVence: posts small blind €0.01
albertito151: posts big blind €0.02
*** HOLE CARDS ***
Dealt to Luckers712 [8s 4d]
chiwas12: folds
Marlock10: folds
unounoporfavor: raises €0.02 to €0.04
Luckers712: folds
PatrickVence: folds
albertito151: folds
Uncalled bet (€0.02) returned to unounoporfavor
unounoporfavor collected €0.05 from pot
unounoporfavor: doesn't show hand
*** SUMMARY ***
Total pot €0.05 | Rake €0
Seat 1: Luckers712 (button) folded before Flop (didn't bet)
Seat 2: PatrickVence (small blind) folded before Flop
Seat 3: albertito151 (big blind) folded before Flop
Seat 4: chiwas12 folded before Flop (didn't bet)
Seat 5: Marlock10 folded before Flop (didn't bet)
Seat 6: unounoporfavor collected (€0.05)



PokerStars Zoom Hand #210168210635:  Hold'em No Limit (€0.01/€0.02) - 2020/03/15 19:01:16 CET [2020/03/15 14:01:16 ET]
Table 'Arneb' 6-max Seat #1 is the button
Seat 1: Luckers712 (€2.41 in chips)
Seat 2: Marlock10 (€1 in chips)
Seat 3: javimagnu (€2.16 in chips)
Seat 4: juantiogot (€4.51 in chips)
Seat 5: cusebre (€2.59 in chips)
Seat 6: nervolous (€3.91 in chips)
Marlock10: posts small blind €0.01
javimagnu: posts big blind €0.02
*** HOLE CARDS ***
Dealt to Luckers712 [8h 7s]
juantiogot: folds
cusebre: folds
nervolous: raises €0.02 to €0.04
Luckers712: folds
Marlock10: folds
javimagnu: calls €0.02
*** FLOP *** [Qh Js 9c]
javimagnu: checks
nervolous: bets €0.02
javimagnu: raises €0.08 to €0.10
nervolous: folds
Uncalled bet (€0.08) returned to javimagnu
javimagnu collected €0.12 from pot
javimagnu: doesn't show hand
*** SUMMARY ***
Total pot €0.13 | Rake €0.01
Board [Qh Js 9c]
Seat 1: Luckers712 (button) folded before Flop (didn't bet)
Seat 2: Marlock10 (small blind) folded before Flop
Seat 3: javimagnu (big blind) collected (€0.12)
Seat 4: juantiogot folded before Flop (didn't bet)
Seat 5: cusebre folded before Flop (didn't bet)
Seat 6: nervolous folded on the Flop



PokerStars Zoom Hand #210168246863:  Hold'em No Limit (€0.01/€0.02) - 2020/03/15 19:02:02 CET [2020/03/15 14:02:02 ET]
Table 'Arneb' 6-max Seat #1 is the button
Seat 1: xSirc (€2.82 in chips)
Seat 2: bilboubou78 (€2.75 in chips)
Seat 3: mounty22333 (€0.90 in chips)
Seat 4: ruben33333 (€1.06 in chips)
Seat 5: Luckers712 (€2.41 in chips)
Seat 6: M5dias (€3.76 in chips)
bilboubou78: posts small blind €0.01
mounty22333: posts big blind €0.02
*** HOLE CARDS ***
Dealt to Luckers712 [2s Qh]
ruben33333: folds
Luckers712: folds
M5dias: folds
xSirc: folds
bilboubou78: folds
Uncalled bet (€0.01) returned to mounty22333
mounty22333 collected €0.02 from pot
mounty22333: doesn't show hand
*** SUMMARY ***
Total pot €0.02 | Rake €0
Seat 1: xSirc (button) folded before Flop (didn't bet)
Seat 2: bilboubou78 (small blind) folded before Flop
Seat 3: mounty22333 (big blind) collected (€0.02)
Seat 4: ruben33333 folded before Flop (didn't bet)
Seat 5: Luckers712 folded before Flop (didn't bet)
Seat 6: M5dias folded before Flop (didn't bet)



PokerStars Zoom Hand #210168216560:  Hold'em No Limit (€0.01/€0.02) - 2020/03/15 19:01:24 CET [2020/03/15 14:01:24 ET]
Table 'Arneb' 6-max Seat #1 is the button
Seat 1: Chipburguer (€4.68 in chips)
Seat 2: albertito151 (€2.56 in chips)
Seat 3: frodoh1 (€3.30 in chips)
Seat 4: les_f1lous (€3.07 in chips)
Seat 5: Dark_make632 (€2 in chips)
Seat 6: Luckers712 (€2.41 in chips)
albertito151: posts small blind €0.01
frodoh1: posts big blind €0.02
*** HOLE CARDS ***
Dealt to Luckers712 [5s Qd]
les_f1lous: raises €0.02 to €0.04
Dark_make632: folds
Luckers712: folds
Chipburguer: raises €0.12 to €0.16
albertito151: folds
frodoh1: folds
les_f1lous: calls €0.12
*** FLOP *** [Qc Ks 9s]
les_f1lous: checks
Chipburguer: checks
*** TURN *** [Qc Ks 9s] [3s]
les_f1lous: checks
Chipburguer: bets €0.20
les_f1lous: folds
Uncalled bet (€0.20) returned to Chipburguer
Chipburguer collected €0.33 from pot
Chipburguer: doesn't show hand
*** SUMMARY ***
Total pot €0.35 | Rake €0.02
Board [Qc Ks 9s 3s]
Seat 1: Chipburguer (button) collected (€0.33)
Seat 2: albertito151 (small blind) folded before Flop
Seat 3: frodoh1 (big blind) folded before Flop
Seat 4: les_f1lous folded on the Turn
Seat 5: Dark_make632 folded before Flop (didn't bet)
Seat 6: Luckers712 folded before Flop (didn't bet)



PokerStars Zoom Hand #210168250977:  Hold'em No Limit (€0.01/€0.02) - 2020/03/15 19:02:06 CET [2020/03/15 14:02:06 ET]
Table 'Arneb' 6-max Seat #1 is the button
Seat 1: triatlon23 (€2.66 in chips)
Seat 2: clapo44980 (€1.16 in chips)
Seat 3: Luckers712 (€2.41 in chips)
Seat 4: llodio (€4.51 in chips)
Seat 5: NanoLMP (€3.88 in chips)
Seat 6: Franç@ (€6.18 in chips)
clapo44980: posts small blind €0.01
Luckers712: posts big blind €0.02
*** HOLE CARDS ***
Dealt to Luckers712 [4d Td]
llodio: raises €0.04 to €0.06
NanoLMP: folds
Franç@: folds
triatlon23: folds
clapo44980: folds
Luckers712: folds
Uncalled bet (€0.04) returned to llodio
llodio collected €0.05 from pot
llodio: doesn't show hand
*** SUMMARY ***
Total pot €0.05 | Rake €0
Seat 1: triatlon23 (button) folded before Flop (didn't bet)
Seat 2: clapo44980 (small blind) folded before Flop
Seat 3: Luckers712 (big blind) folded before Flop
Seat 4: llodio collected (€0.05)
Seat 5: NanoLMP folded before Flop (didn't bet)
Seat 6: Franç@ folded before Flop (didn't bet)



PokerStars Zoom Hand #210168220372:  Hold'em No Limit (€0.01/€0.02) - 2020/03/15 19:01:29 CET [2020/03/15 14:01:29 ET]
Table 'Arneb' 6-max Seat #1 is the button
Seat 1: javigarrido8 (€2.18 in chips)
Seat 2: El moro78 (€2.32 in chips)
Seat 3: Latutor13 (€2.10 in chips)
Seat 4: LeJoueurDuNonA (€2 in chips)
Seat 5: Luckers712 (€2.41 in chips)
Seat 6: mousepro9 (€2 in chips)
El moro78: posts small blind €0.01
Latutor13: posts big blind €0.02
*** HOLE CARDS ***
Dealt to Luckers712 [5c Ah]
LeJoueurDuNonA: folds
Luckers712: folds
mousepro9: folds
javigarrido8: raises €0.03 to €0.05
El moro78: calls €0.04
Latutor13: folds
*** FLOP *** [3d 3h 2c]
El moro78: checks
javigarrido8: checks
*** TURN *** [3d 3h 2c] [7c]
El moro78: bets €0.07
javigarrido8: folds
Uncalled bet (€0.07) returned to El moro78
El moro78 collected €0.11 from pot
El moro78: doesn't show hand
*** SUMMARY ***
Total pot €0.12 | Rake €0.01
Board [3d 3h 2c 7c]
Seat 1: javigarrido8 (button) folded on the Turn
Seat 2: El moro78 (small blind) collected (€0.11)
Seat 3: Latutor13 (big blind) folded before Flop
Seat 4: LeJoueurDuNonA folded before Flop (didn't bet)
Seat 5: Luckers712 folded before Flop (didn't bet)
Seat 6: mousepro9 folded before Flop (didn't bet)



PokerStars Zoom Hand #210168243565:  Hold'em No Limit (€0.01/€0.02) - 2020/03/15 19:01:58 CET [2020/03/15 14:01:58 ET]
Table 'Arneb' 6-max Seat #1 is the button
Seat 1: nervolous (€1.04 in chips)
Seat 2: The dead97 (€2.75 in chips)
Seat 3: NanoLMP (€2.03 in chips)
Seat 4: Cangrejocotyx (€0.97 in chips)
Seat 5: chiwas12 (€2.10 in chips)
Seat 6: Luckers712 (€2.41 in chips)
The dead97: posts small blind €0.01
NanoLMP: posts big blind €0.02
*** HOLE CARDS ***
Dealt to Luckers712 [3c 6s]
Cangrejocotyx: folds
chiwas12: folds
Luckers712: folds
nervolous: folds
The dead97: raises €0.04 to €0.06
NanoLMP: calls €0.04
*** FLOP *** [2s Jc Qs]
The dead97: checks
NanoLMP: checks
*** TURN *** [2s Jc Qs] [As]
The dead97: checks
NanoLMP: checks
*** RIVER *** [2s Jc Qs As] [Jh]
The dead97: checks
NanoLMP: bets €0.03
The dead97: folds
Uncalled bet (€0.03) returned to NanoLMP
NanoLMP collected €0.11 from pot
NanoLMP: doesn't show hand
*** SUMMARY ***
Total pot €0.12 | Rake €0.01
Board [2s Jc Qs As Jh]
Seat 1: nervolous (button) folded before Flop (didn't bet)
Seat 2: The dead97 (small blind) folded on the River
Seat 3: NanoLMP (big blind) collected (€0.11)
Seat 4: Cangrejocotyx folded before Flop (didn't bet)
Seat 5: chiwas12 folded before Flop (didn't bet)
Seat 6: Luckers712 folded before Flop (didn't bet)



PokerStars Zoom Hand #210168257376:  Hold'em No Limit (€0.01/€0.02) - 2020/03/15 19:02:14 CET [2020/03/15 14:02:14 ET]
Table 'Arneb' 6-max Seat #1 is the button
Seat 1: Pescas21 (€3.25 in chips)
Seat 2: Luckers712 (€2.39 in chips)
Seat 3: chrisvlr65 (€2.02 in chips)
Seat 4: mousepro9 (€4.18 in chips)
Seat 5: aportiquevoy (€3.04 in chips)
Seat 6: xSirc (€2.82 in chips)
Luckers712: posts small blind €0.01
chrisvlr65: posts big blind €0.02
*** HOLE CARDS ***
Dealt to Luckers712 [Kc Jc]
mousepro9: raises €0.04 to €0.06
aportiquevoy: folds
xSirc: folds
Pescas21: calls €0.06
Luckers712: calls €0.05
chrisvlr65: folds
*** FLOP *** [2h Qd Ts]
Luckers712: checks
mousepro9: bets €0.10
Pescas21: calls €0.10
Luckers712: raises €0.31 to €0.41
mousepro9: folds
Pescas21: folds
Uncalled bet (€0.31) returned to Luckers712
Luckers712 collected €0.48 from pot
Luckers712: doesn't show hand
*** SUMMARY ***
Total pot €0.50 | Rake €0.02
Board [2h Qd Ts]
Seat 1: Pescas21 (button) folded on the Flop
Seat 2: Luckers712 (small blind) collected (€0.48)
Seat 3: chrisvlr65 (big blind) folded before Flop
Seat 4: mousepro9 folded on the Flop
Seat 5: aportiquevoy folded before Flop (didn't bet)
Seat 6: xSirc folded before Flop (didn't bet)



PokerStars Zoom Hand #210168305526:  Hold'em No Limit (€0.01/€0.02) - 2020/03/15 19:03:08 CET [2020/03/15 14:03:08 ET]
Table 'Arneb' 6-max Seat #1 is the button
Seat 1: fcruz91 (€2.72 in chips)
Seat 2: ~mRG^^54 (€2 in chips)
Seat 3: cañon000 (€1.68 in chips)
Seat 4: Luckers712 (€2.71 in chips)
Seat 5: chiwas12 (€2.79 in chips)
Seat 6: bilboubou78 (€4.02 in chips)
~mRG^^54: posts small blind €0.01
cañon000: posts big blind €0.02
*** HOLE CARDS ***
Dealt to Luckers712 [9d 4d]
Luckers712: folds
chiwas12: folds
bilboubou78: folds
fcruz91: folds
~mRG^^54: folds
Uncalled bet (€0.01) returned to cañon000
cañon000 collected €0.02 from pot
cañon000: doesn't show hand
*** SUMMARY ***
Total pot €0.02 | Rake €0
Seat 1: fcruz91 (button) folded before Flop (didn't bet)
Seat 2: ~mRG^^54 (small blind) folded before Flop
Seat 3: cañon000 (big blind) collected (€0.02)
Seat 4: Luckers712 folded before Flop (didn't bet)
Seat 5: chiwas12 folded before Flop (didn't bet)
Seat 6: bilboubou78 folded before Flop (didn't bet)



PokerStars Zoom Hand #210168309017:  Hold'em No Limit (€0.01/€0.02) - 2020/03/15 19:03:12 CET [2020/03/15 14:03:12 ET]
Table 'Arneb' 6-max Seat #1 is the button
Seat 1: Luckers712 (€2.71 in chips)
Seat 2: trakson (€3.40 in chips)
Seat 3: Anme41 (€2.09 in chips)
Seat 4: NanoLMP (€2.08 in chips)
Seat 5: raptureman1 (€2.28 in chips)
Seat 6: ciclo230385 (€2 in chips)
trakson: posts small blind €0.01
Anme41: posts big blind €0.02
*** HOLE CARDS ***
Dealt to Luckers712 [4h As]
NanoLMP: folds
raptureman1: folds
ciclo230385: folds
Luckers712: raises €0.03 to €0.05
trakson: folds
Anme41: calls €0.03
*** FLOP *** [Js 2d 5s]
Anme41: checks
Luckers712: checks
*** TURN *** [Js 2d 5s] [2s]
Anme41: checks
Luckers712: checks
*** RIVER *** [Js 2d 5s 2s] [Th]
Anme41: checks
Luckers712: checks
*** SHOW DOWN ***
Anme41: shows [7c Tc] (two pair, Tens and Deuces)
Luckers712: mucks hand
Anme41 collected €0.10 from pot
*** SUMMARY ***
Total pot €0.11 | Rake €0.01
Board [Js 2d 5s 2s Th]
Seat 1: Luckers712 (button) mucked [4h As]
Seat 2: trakson (small blind) folded before Flop
Seat 3: Anme41 (big blind) showed [7c Tc] and won (€0.10) with two pair, Tens and Deuces
Seat 4: NanoLMP folded before Flop (didn't bet)
Seat 5: raptureman1 folded before Flop (didn't bet)
Seat 6: ciclo230385 folded before Flop (didn't bet)



PokerStars Zoom Hand #210168346496:  Hold'em No Limit (€0.01/€0.02) - 2020/03/15 19:03:51 CET [2020/03/15 14:03:51 ET]
Table 'Arneb' 6-max Seat #1 is the button
Seat 1: lucky13re (€2.17 in chips)
Seat 2: les_f1lous (€2.92 in chips)
Seat 3: nervolous (€3.79 in chips)
Seat 4: vatol0co (€2.09 in chips)
Seat 5: xSirc (€2.83 in chips)
Seat 6: Luckers712 (€2.66 in chips)
les_f1lous: posts small blind €0.01
nervolous: posts big blind €0.02
*** HOLE CARDS ***
Dealt to Luckers712 [7c 8d]
vatol0co: folds
xSirc: folds
Luckers712: folds
lucky13re: folds
les_f1lous: folds
Uncalled bet (€0.01) returned to nervolous
nervolous collected €0.02 from pot
nervolous: doesn't show hand
*** SUMMARY ***
Total pot €0.02 | Rake €0
Seat 1: lucky13re (button) folded before Flop (didn't bet)
Seat 2: les_f1lous (small blind) folded before Flop
Seat 3: nervolous (big blind) collected (€0.02)
Seat 4: vatol0co folded before Flop (didn't bet)
Seat 5: xSirc folded before Flop (didn't bet)
Seat 6: Luckers712 folded before Flop (didn't bet)



PokerStars Zoom Hand #210168357332:  Hold'em No Limit (€0.01/€0.02) - 2020/03/15 19:04:03 CET [2020/03/15 14:04:03 ET]
Table 'Arneb' 6-max Seat #1 is the button
Seat 1: Capitan Aab (€2 in chips)
Seat 2: TJDasNeves (€2.09 in chips)
Seat 3: Capoutch15 (€2.07 in chips)
Seat 4: Luckers712 (€2.66 in chips)
Seat 5: estevi_79 (€5.40 in chips)
Seat 6: radlau (€1.81 in chips)
TJDasNeves: posts small blind €0.01
Capoutch15: posts big blind €0.02
*** HOLE CARDS ***
Dealt to Luckers712 [Jh Jd]
Luckers712: raises €0.03 to €0.05
estevi_79: folds
radlau: folds
Capitan Aab: folds
TJDasNeves: folds
Capoutch15: folds
Uncalled bet (€0.03) returned to Luckers712
Luckers712 collected €0.05 from pot
Luckers712: doesn't show hand
*** SUMMARY ***
Total pot €0.05 | Rake €0
Seat 1: Capitan Aab (button) folded before Flop (didn't bet)
Seat 2: TJDasNeves (small blind) folded before Flop
Seat 3: Capoutch15 (big blind) folded before Flop
Seat 4: Luckers712 collected (€0.05)
Seat 5: estevi_79 folded before Flop (didn't bet)
Seat 6: radlau folded before Flop (didn't bet)



PokerStars Zoom Hand #210168370194:  Hold'em No Limit (€0.01/€0.02) - 2020/03/15 19:04:16 CET [2020/03/15 14:04:16 ET]
Table 'Arneb' 6-max Seat #1 is the button
Seat 1: chiwas12 (€6.03 in chips)
Seat 2: Marlock10 (€1.20 in chips)
Seat 3: Luckers712 (€2.69 in chips)
Seat 4: Comino79 (€1.85 in chips)
Seat 5: Vitorero (€2 in chips)
Seat 6: M5dias (€3.35 in chips)
Marlock10: posts small blind €0.01
Luckers712: posts big blind €0.02
*** HOLE CARDS ***
Dealt to Luckers712 [Qc 2d]
Comino79: folds
Vitorero: raises €0.03 to €0.05
M5dias: folds
chiwas12: folds
Marlock10: folds
Luckers712: folds
Uncalled bet (€0.03) returned to Vitorero
Vitorero collected €0.05 from pot
Vitorero: doesn't show hand
*** SUMMARY ***
Total pot €0.05 | Rake €0
Seat 1: chiwas12 (button) folded before Flop (didn't bet)
Seat 2: Marlock10 (small blind) folded before Flop
Seat 3: Luckers712 (big blind) folded before Flop
Seat 4: Comino79 folded before Flop (didn't bet)
Seat 5: Vitorero collected (€0.05)
Seat 6: M5dias folded before Flop (didn't bet)



PokerStars Zoom Hand #210168350081:  Hold'em No Limit (€0.01/€0.02) - 2020/03/15 19:03:55 CET [2020/03/15 14:03:55 ET]
Table 'Arneb' 6-max Seat #1 is the button
Seat 1: mugen1928 (€2 in chips)
Seat 2: Comlan22 (€2.04 in chips)
Seat 3: ElvasSniper (€2.05 in chips)
Seat 4: AnteroNeves (€2.06 in chips)
Seat 5: Luckers712 (€2.66 in chips)
Seat 6: bilboubou78 (€2.86 in chips)
Comlan22: posts small blind €0.01
ElvasSniper: posts big blind €0.02
*** HOLE CARDS ***
Dealt to Luckers712 [Kh 3c]
AnteroNeves: folds
Luckers712: folds
bilboubou78: folds
mugen1928: folds
Comlan22: calls €0.01
ElvasSniper: checks
*** FLOP *** [6s 4h 9d]
Comlan22: checks
ElvasSniper: checks
*** TURN *** [6s 4h 9d] [Qc]
Comlan22: bets €0.04
ElvasSniper: folds
Uncalled bet (€0.04) returned to Comlan22
Comlan22 collected €0.04 from pot
Comlan22: doesn't show hand
*** SUMMARY ***
Total pot €0.04 | Rake €0
Board [6s 4h 9d Qc]
Seat 1: mugen1928 (button) folded before Flop (didn't bet)
Seat 2: Comlan22 (small blind) collected (€0.04)
Seat 3: ElvasSniper (big blind) folded on the Turn
Seat 4: AnteroNeves folded before Flop (didn't bet)
Seat 5: Luckers712 folded before Flop (didn't bet)
Seat 6: bilboubou78 folded before Flop (didn't bet)



PokerStars Zoom Hand #210168378544:  Hold'em No Limit (€0.01/€0.02) - 2020/03/15 19:04:25 CET [2020/03/15 14:04:25 ET]
Table 'Arneb' 6-max Seat #1 is the button
Seat 1: Galin1312 (€2.02 in chips)
Seat 2: Luckers712 (€2.67 in chips)
Seat 3: Anme41 (€2.13 in chips)
Seat 4: Markitos PT (€2.17 in chips)
Seat 5: pastorii22 (€0.76 in chips)
Seat 6: vicente13142 (€7.32 in chips)
Luckers712: posts small blind €0.01
Anme41: posts big blind €0.02
*** HOLE CARDS ***
Dealt to Luckers712 [7c 5h]
Markitos PT: folds
pastorii22: folds
vicente13142: raises €0.04 to €0.06
Galin1312: folds
Luckers712: folds
Anme41: folds
Uncalled bet (€0.04) returned to vicente13142
vicente13142 collected €0.05 from pot
vicente13142: doesn't show hand
*** SUMMARY ***
Total pot €0.05 | Rake €0
Seat 1: Galin1312 (button) folded before Flop (didn't bet)
Seat 2: Luckers712 (small blind) folded before Flop
Seat 3: Anme41 (big blind) folded before Flop
Seat 4: Markitos PT folded before Flop (didn't bet)
Seat 5: pastorii22 folded before Flop (didn't bet)
Seat 6: vicente13142 collected (€0.05)



PokerStars Zoom Hand #210168382242:  Hold'em No Limit (€0.01/€0.02) - 2020/03/15 19:04:29 CET [2020/03/15 14:04:29 ET]
Table 'Arneb' 6-max Seat #1 is the button
Seat 1: Luckers712 (€2.66 in chips)
Seat 2: chrisvlr65 (€2.06 in chips)
Seat 3: les_f1lous (€2.94 in chips)
Seat 4: TJDasNeves (€2.08 in chips)
Seat 5: PITI1231 (€7.39 in chips)
Seat 6: tetar1000d (€2 in chips)
chrisvlr65: posts small blind €0.01
les_f1lous: posts big blind €0.02
*** HOLE CARDS ***
Dealt to Luckers712 [Qc 5s]
TJDasNeves: folds
PITI1231: folds
tetar1000d: folds
Luckers712: folds
chrisvlr65: calls €0.01
les_f1lous: checks
*** FLOP *** [Js Ks 5c]
chrisvlr65: checks
les_f1lous: checks
*** TURN *** [Js Ks 5c] [Ah]
chrisvlr65: checks
les_f1lous: checks
*** RIVER *** [Js Ks 5c Ah] [Qd]
chrisvlr65: checks
les_f1lous: checks
*** SHOW DOWN ***
chrisvlr65: shows [Ac 3s] (a pair of Aces)
les_f1lous: mucks hand
chrisvlr65 collected €0.04 from pot
*** SUMMARY ***
Total pot €0.04 | Rake €0
Board [Js Ks 5c Ah Qd]
Seat 1: Luckers712 (button) folded before Flop (didn't bet)
Seat 2: chrisvlr65 (small blind) showed [Ac 3s] and won (€0.04) with a pair of Aces
Seat 3: les_f1lous (big blind) mucked [6h 8c]
Seat 4: TJDasNeves folded before Flop (didn't bet)
Seat 5: PITI1231 folded before Flop (didn't bet)
Seat 6: tetar1000d folded before Flop (didn't bet)



PokerStars Zoom Hand #210168394253:  Hold'em No Limit (€0.01/€0.02) - 2020/03/15 19:04:42 CET [2020/03/15 14:04:42 ET]
Table 'Arneb' 6-max Seat #1 is the button
Seat 1: ElvasSniper (€2.03 in chips)
Seat 2: JMB1893 (€2.48 in chips)
Seat 3: Luckers712 (€2.66 in chips)
Seat 4: Baby Alligator (€4.59 in chips)
Seat 5: XXXMJA (€2.16 in chips)
Seat 6: Kayfidze (€3.41 in chips)
JMB1893: posts small blind €0.01
Luckers712: posts big blind €0.02
*** HOLE CARDS ***
Dealt to Luckers712 [3d 2s]
Baby Alligator: folds
XXXMJA: folds
Kayfidze: folds
ElvasSniper: folds
JMB1893: folds
Uncalled bet (€0.01) returned to Luckers712
Luckers712 collected €0.02 from pot
Luckers712: doesn't show hand
*** SUMMARY ***
Total pot €0.02 | Rake €0
Seat 1: ElvasSniper (button) folded before Flop (didn't bet)
Seat 2: JMB1893 (small blind) folded before Flop
Seat 3: Luckers712 (big blind) collected (€0.02)
Seat 4: Baby Alligator folded before Flop (didn't bet)
Seat 5: XXXMJA folded before Flop (didn't bet)
Seat 6: Kayfidze folded before Flop (didn't bet)



PokerStars Zoom Hand #210168387736:  Hold'em No Limit (€0.01/€0.02) - 2020/03/15 19:04:35 CET [2020/03/15 14:04:35 ET]
Table 'Arneb' 6-max Seat #1 is the button
Seat 1: MigDmaria (€2.61 in chips)
Seat 2: MORENODCADI (€0.93 in chips)
Seat 3: unounoporfavor (€6.46 in chips)
Seat 4: toniton888 (€0.64 in chips)
Seat 5: Alibasy (€1.68 in chips)
Seat 6: Luckers712 (€2.66 in chips)
MORENODCADI: posts small blind €0.01
unounoporfavor: posts big blind €0.02
*** HOLE CARDS ***
Dealt to Luckers712 [4c 5c]
toniton888: calls €0.02
Alibasy: folds
Luckers712: folds
MigDmaria: raises €0.06 to €0.08
MORENODCADI: folds
unounoporfavor: folds
toniton888: calls €0.06
*** FLOP *** [4d 2d Kh]
toniton888: checks
MigDmaria: bets €0.09
toniton888: folds
Uncalled bet (€0.09) returned to MigDmaria
MigDmaria collected €0.18 from pot
MigDmaria: doesn't show hand
*** SUMMARY ***
Total pot €0.19 | Rake €0.01
Board [4d 2d Kh]
Seat 1: MigDmaria (button) collected (€0.18)
Seat 2: MORENODCADI (small blind) folded before Flop
Seat 3: unounoporfavor (big blind) folded before Flop
Seat 4: toniton888 folded on the Flop
Seat 5: Alibasy folded before Flop (didn't bet)
Seat 6: Luckers712 folded before Flop (didn't bet)



PokerStars Zoom Hand #210168353794:  Hold'em No Limit (€0.01/€0.02) - 2020/03/15 19:03:59 CET [2020/03/15 14:03:59 ET]
Table 'Arneb' 6-max Seat #1 is the button
Seat 1: Vitorero (€2.14 in chips)
Seat 2: raptureman1 (€2.27 in chips)
Seat 3: MigDmaria (€2 in chips)
Seat 4: Luckers712 (€2.66 in chips)
Seat 5: bilboubou78 (€2.75 in chips)
Seat 6: Dark_make632 (€3.04 in chips)
raptureman1: posts small blind €0.01
MigDmaria: posts big blind €0.02
*** HOLE CARDS ***
Dealt to Luckers712 [Tc 6s]
Luckers712: folds
bilboubou78: folds
Dark_make632: folds
Vitorero: raises €0.03 to €0.05
raptureman1: calls €0.04
MigDmaria: calls €0.03
*** FLOP *** [Ts 9c Kh]
raptureman1: checks
MigDmaria: checks
Vitorero: checks
*** TURN *** [Ts 9c Kh] [3s]
raptureman1: checks
MigDmaria: checks
Vitorero: checks
*** RIVER *** [Ts 9c Kh 3s] [6d]
raptureman1: checks
MigDmaria: bets €0.14
Vitorero: folds
raptureman1: folds
Uncalled bet (€0.14) returned to MigDmaria
MigDmaria collected €0.14 from pot
MigDmaria: doesn't show hand
*** SUMMARY ***
Total pot €0.15 | Rake €0.01
Board [Ts 9c Kh 3s 6d]
Seat 1: Vitorero (button) folded on the River
Seat 2: raptureman1 (small blind) folded on the River
Seat 3: MigDmaria (big blind) collected (€0.14)
Seat 4: Luckers712 folded before Flop (didn't bet)
Seat 5: bilboubou78 folded before Flop (didn't bet)
Seat 6: Dark_make632 folded before Flop (didn't bet)



PokerStars Zoom Hand #210168403675:  Hold'em No Limit (€0.01/€0.02) - 2020/03/15 19:04:52 CET [2020/03/15 14:04:52 ET]
Table 'Arneb' 6-max Seat #1 is the button
Seat 1: Chipburguer (€4.82 in chips)
Seat 2: RecKings (€2.05 in chips)
Seat 3: sau1888 (€1.97 in chips)
Seat 4: Luckers712 (€2.67 in chips)
Seat 5: mugen1928 (€2.01 in chips)
Seat 6: safelifetop (€2 in chips)
RecKings: posts small blind €0.01
sau1888: posts big blind €0.02
*** HOLE CARDS ***
Dealt to Luckers712 [Jd Jc]
Luckers712: raises €0.04 to €0.06
mugen1928: folds
safelifetop: folds
Chipburguer: calls €0.06
RecKings: folds
sau1888: calls €0.04
*** FLOP *** [4d Kh 3s]
sau1888: checks
Luckers712: checks
Chipburguer: bets €0.06
sau1888: calls €0.06
Luckers712: calls €0.06
*** TURN *** [4d Kh 3s] [9d]
sau1888: checks
Luckers712: checks
Chipburguer: checks
*** RIVER *** [4d Kh 3s 9d] [Qc]
sau1888: bets €0.35
Luckers712: folds
Chipburguer: folds
Uncalled bet (€0.35) returned to sau1888
sau1888 collected €0.35 from pot
sau1888: doesn't show hand
*** SUMMARY ***
Total pot €0.37 | Rake €0.02
Board [4d Kh 3s 9d Qc]
Seat 1: Chipburguer (button) folded on the River
Seat 2: RecKings (small blind) folded before Flop
Seat 3: sau1888 (big blind) collected (€0.35)
Seat 4: Luckers712 folded on the River
Seat 5: mugen1928 folded before Flop (didn't bet)
Seat 6: safelifetop folded before Flop (didn't bet)



PokerStars Zoom Hand #210168460310:  Hold'em No Limit (€0.01/€0.02) - 2020/03/15 19:05:51 CET [2020/03/15 14:05:51 ET]
Table 'Arneb' 6-max Seat #1 is the button
Seat 1: martingete (€1.95 in chips)
Seat 2: Púlsar (€1.94 in chips)
Seat 3: trakson (€3.44 in chips)
Seat 4: Comlan22 (€2.03 in chips)
Seat 5: Luckers712 (€2.54 in chips)
Seat 6: Veesile (€2.05 in chips)
Púlsar: posts small blind €0.01
trakson: posts big blind €0.02
*** HOLE CARDS ***
Dealt to Luckers712 [Ts Qc]
Comlan22: folds
Luckers712: folds
Veesile: folds
martingete: folds
Púlsar: raises €0.02 to €0.04
trakson: calls €0.02
*** FLOP *** [2h Kd 7h]
Púlsar: bets €0.04
trakson: folds
Uncalled bet (€0.04) returned to Púlsar
Púlsar collected €0.08 from pot
Púlsar: doesn't show hand
*** SUMMARY ***
Total pot €0.08 | Rake €0
Board [2h Kd 7h]
Seat 1: martingete (button) folded before Flop (didn't bet)
Seat 2: Púlsar (small blind) collected (€0.08)
Seat 3: trakson (big blind) folded on the Flop
Seat 4: Comlan22 folded before Flop (didn't bet)
Seat 5: Luckers712 folded before Flop (didn't bet)
Seat 6: Veesile folded before Flop (didn't bet)



PokerStars Zoom Hand #210168475552:  Hold'em No Limit (€0.01/€0.02) - 2020/03/15 19:06:07 CET [2020/03/15 14:06:07 ET]
Table 'Arneb' 6-max Seat #1 is the button
Seat 1: Luckers712 (€2.54 in chips)
Seat 2: RecKings (€2.02 in chips)
Seat 3: Romanshev (€2.21 in chips)
Seat 4: Anme41 (€2.04 in chips)
Seat 5: @Anab29 (€3.09 in chips)
Seat 6: PACTE76 (€4.76 in chips)
RecKings: posts small blind €0.01
Romanshev: posts big blind €0.02
*** HOLE CARDS ***
Dealt to Luckers712 [Th Qc]
Anme41: folds
@Anab29: raises €0.02 to €0.04
PACTE76: folds
Luckers712: folds
RecKings: folds
Romanshev: folds
Uncalled bet (€0.02) returned to @Anab29
@Anab29 collected €0.05 from pot
@Anab29: doesn't show hand
*** SUMMARY ***
Total pot €0.05 | Rake €0
Seat 1: Luckers712 (button) folded before Flop (didn't bet)
Seat 2: RecKings (small blind) folded before Flop
Seat 3: Romanshev (big blind) folded before Flop
Seat 4: Anme41 folded before Flop (didn't bet)
Seat 5: @Anab29 collected (€0.05)
Seat 6: PACTE76 folded before Flop (didn't bet)



PokerStars Zoom Hand #210168455500:  Hold'em No Limit (€0.01/€0.02) - 2020/03/15 19:05:46 CET [2020/03/15 14:05:46 ET]
Table 'Arneb' 6-max Seat #1 is the button
Seat 1: TJDasNeves (€2.90 in chips)
Seat 2: Luckers712 (€2.55 in chips)
Seat 3: Tatxan (€2.50 in chips)
Seat 4: trakson (€3.44 in chips)
Seat 5: JMB1893 (€2.65 in chips)
Seat 6: bilboubou78 (€3.02 in chips)
Luckers712: posts small blind €0.01
Tatxan: posts big blind €0.02
*** HOLE CARDS ***
Dealt to Luckers712 [2c 5h]
trakson: folds
JMB1893: folds
bilboubou78: raises €0.04 to €0.06
TJDasNeves: calls €0.06
Luckers712: folds
Tatxan: folds
*** FLOP *** [9s Jd 4c]
bilboubou78: bets €0.08
TJDasNeves: calls €0.08
*** TURN *** [9s Jd 4c] [Ad]
bilboubou78: bets €0.16
TJDasNeves: calls €0.16
*** RIVER *** [9s Jd 4c Ad] [7c]
bilboubou78: bets €0.38
TJDasNeves: calls €0.38
*** SHOW DOWN ***
bilboubou78: shows [Ah Jc] (two pair, Aces and Jacks)
TJDasNeves: mucks hand
bilboubou78 collected €1.32 from pot
*** SUMMARY ***
Total pot €1.39 | Rake €0.07
Board [9s Jd 4c Ad 7c]
Seat 1: TJDasNeves (button) mucked [7d 4d]
Seat 2: Luckers712 (small blind) folded before Flop
Seat 3: Tatxan (big blind) folded before Flop
Seat 4: trakson folded before Flop (didn't bet)
Seat 5: JMB1893 folded before Flop (didn't bet)
Seat 6: bilboubou78 showed [Ah Jc] and won (€1.32) with two pair, Aces and Jacks



PokerStars Zoom Hand #210168471697:  Hold'em No Limit (€0.01/€0.02) - 2020/03/15 19:06:03 CET [2020/03/15 14:06:03 ET]
Table 'Arneb' 6-max Seat #1 is the button
Seat 1: toppo24 (€3.28 in chips)
Seat 2: ekzemaker (€6.21 in chips)
Seat 3: PatrickVence (€2.56 in chips)
Seat 4: adrivicente (€4.25 in chips)
Seat 5: tunningboy67 (€1.67 in chips)
Seat 6: Luckers712 (€2.54 in chips)
ekzemaker: posts small blind €0.01
PatrickVence: posts big blind €0.02
*** HOLE CARDS ***
Dealt to Luckers712 [7c 5s]
adrivicente: raises €0.03 to €0.05
tunningboy67: folds
Luckers712: folds
toppo24: folds
ekzemaker: folds
PatrickVence: calls €0.03
*** FLOP *** [Ts 7h Jh]
PatrickVence: checks
adrivicente: checks
*** TURN *** [Ts 7h Jh] [Th]
PatrickVence: checks
adrivicente: checks
*** RIVER *** [Ts 7h Jh Th] [5d]
PatrickVence: bets €0.04
adrivicente: folds
Uncalled bet (€0.04) returned to PatrickVence
PatrickVence collected €0.10 from pot
PatrickVence: doesn't show hand
*** SUMMARY ***
Total pot €0.11 | Rake €0.01
Board [Ts 7h Jh Th 5d]
Seat 1: toppo24 (button) folded before Flop (didn't bet)
Seat 2: ekzemaker (small blind) folded before Flop
Seat 3: PatrickVence (big blind) collected (€0.10)
Seat 4: adrivicente folded on the River
Seat 5: tunningboy67 folded before Flop (didn't bet)
Seat 6: Luckers712 folded before Flop (didn't bet)



PokerStars Zoom Hand #210168481261:  Hold'em No Limit (€0.01/€0.02) - 2020/03/15 19:06:13 CET [2020/03/15 14:06:13 ET]
Table 'Arneb' 6-max Seat #1 is the button
Seat 1: Luckers712 (€2.54 in chips)
Seat 2: patty1291 (€2.25 in chips)
Seat 3: Alex2140Alex (€1.40 in chips)
Seat 4: PATJOCK (€1.88 in chips)
Seat 5: javimagnu (€2.27 in chips)
Seat 6: cad1959 (€2 in chips)
patty1291: posts small blind €0.01
Alex2140Alex: posts big blind €0.02
*** HOLE CARDS ***
Dealt to Luckers712 [4s 5s]
PATJOCK: folds
javimagnu: folds
cad1959: folds
Luckers712: raises €0.02 to €0.04
patty1291: calls €0.03
Alex2140Alex: calls €0.02
*** FLOP *** [8h Qh Ah]
patty1291: bets €0.02
Alex2140Alex: folds
Luckers712: folds
Uncalled bet (€0.02) returned to patty1291
patty1291 collected €0.11 from pot
patty1291: doesn't show hand
*** SUMMARY ***
Total pot €0.12 | Rake €0.01
Board [8h Qh Ah]
Seat 1: Luckers712 (button) folded on the Flop
Seat 2: patty1291 (small blind) collected (€0.11)
Seat 3: Alex2140Alex (big blind) folded on the Flop
Seat 4: PATJOCK folded before Flop (didn't bet)
Seat 5: javimagnu folded before Flop (didn't bet)
Seat 6: cad1959 folded before Flop (didn't bet)



PokerStars Zoom Hand #210168466867:  Hold'em No Limit (€0.01/€0.02) - 2020/03/15 19:05:58 CET [2020/03/15 14:05:58 ET]
Table 'Arneb' 6-max Seat #1 is the button
Seat 1: jparrasa (€2 in chips)
Seat 2: ciclo230385 (€2.03 in chips)
Seat 3: albertito151 (€4.69 in chips)
Seat 4: Luckers712 (€2.54 in chips)
Seat 5: isildur5793 (€3.12 in chips)
Seat 6: @Anab29 (€3.09 in chips)
ciclo230385: posts small blind €0.01
albertito151: posts big blind €0.02
*** HOLE CARDS ***
Dealt to Luckers712 [5h Kc]
Luckers712: folds
isildur5793: folds
@Anab29: folds
jparrasa: raises €0.03 to €0.05
ciclo230385: raises €0.11 to €0.16
albertito151: raises €0.22 to €0.38
jparrasa: folds
ciclo230385: folds
Uncalled bet (€0.22) returned to albertito151
albertito151 collected €0.37 from pot
albertito151: doesn't show hand
*** SUMMARY ***
Total pot €0.37 | Rake €0
Seat 1: jparrasa (button) folded before Flop
Seat 2: ciclo230385 (small blind) folded before Flop
Seat 3: albertito151 (big blind) collected (€0.37)
Seat 4: Luckers712 folded before Flop (didn't bet)
Seat 5: isildur5793 folded before Flop (didn't bet)
Seat 6: @Anab29 folded before Flop (didn't bet)



PokerStars Zoom Hand #210168501046:  Hold'em No Limit (€0.01/€0.02) - 2020/03/15 19:06:34 CET [2020/03/15 14:06:34 ET]
Table 'Arneb' 6-max Seat #1 is the button
Seat 1: triatlon23 (€2.09 in chips)
Seat 2: PATJOCK (€1.88 in chips)
Seat 3: Luckers712 (€2.50 in chips)
Seat 4: bandittours (€2.15 in chips)
Seat 5: sau1888 (€1.98 in chips)
Seat 6: Dark_make632 (€2.71 in chips)
PATJOCK: posts small blind €0.01
Luckers712: posts big blind €0.02
*** HOLE CARDS ***
Dealt to Luckers712 [Ks Kh]
bandittours: folds
sau1888: folds
Dark_make632: folds
triatlon23: raises €0.04 to €0.06
PATJOCK: folds
Luckers712: raises €0.12 to €0.18
triatlon23: calls €0.12
*** FLOP *** [7h 4c 2c]
Luckers712: bets €0.18
triatlon23: folds
Uncalled bet (€0.18) returned to Luckers712
Luckers712 collected €0.35 from pot
Luckers712: doesn't show hand
*** SUMMARY ***
Total pot €0.37 | Rake €0.02
Board [7h 4c 2c]
Seat 1: triatlon23 (button) folded on the Flop
Seat 2: PATJOCK (small blind) folded before Flop
Seat 3: Luckers712 (big blind) collected (€0.35)
Seat 4: bandittours folded before Flop (didn't bet)
Seat 5: sau1888 folded before Flop (didn't bet)
Seat 6: Dark_make632 folded before Flop (didn't bet)



PokerStars Zoom Hand #210168541106:  Hold'em No Limit (€0.01/€0.02) - 2020/03/15 19:07:16 CET [2020/03/15 14:07:16 ET]
Table 'Arneb' 6-max Seat #1 is the button
Seat 1: PITI1231 (€2 in chips)
Seat 2: Luckers712 (€2.67 in chips)
Seat 3: Menorqui (€4.82 in chips)
Seat 4: pandemon (€1.79 in chips)
Seat 5: albertito151 (€2.32 in chips)
Seat 6: Jou"Yonfa$" (€3.76 in chips)
Luckers712: posts small blind €0.01
Menorqui: posts big blind €0.02
*** HOLE CARDS ***
Dealt to Luckers712 [8d 2s]
pandemon: folds
albertito151: folds
Jou"Yonfa$": folds
PITI1231 has timed out
PITI1231: folds
Luckers712: folds
Uncalled bet (€0.01) returned to Menorqui
Menorqui collected €0.02 from pot
Menorqui: doesn't show hand
*** SUMMARY ***
Total pot €0.02 | Rake €0
Seat 1: PITI1231 (button) folded before Flop (didn't bet)
Seat 2: Luckers712 (small blind) folded before Flop
Seat 3: Menorqui (big blind) collected (€0.02)
Seat 4: pandemon folded before Flop (didn't bet)
Seat 5: albertito151 folded before Flop (didn't bet)
Seat 6: Jou"Yonfa$" folded before Flop (didn't bet)



PokerStars Zoom Hand #210168546941:  Hold'em No Limit (€0.01/€0.02) - 2020/03/15 19:07:22 CET [2020/03/15 14:07:22 ET]
Table 'Arneb' 6-max Seat #1 is the button
Seat 1: whiteruss125 (€2.07 in chips)
Seat 2: kingdjass972 (€1.93 in chips)
Seat 3: javimagnu (€2.06 in chips)
Seat 4: ToniMarteens (€2.02 in chips)
Seat 5: Luckers712 (€2.66 in chips)
Seat 6: safelifetop (€2 in chips)
kingdjass972: posts small blind €0.01
javimagnu: posts big blind €0.02
*** HOLE CARDS ***
Dealt to Luckers712 [Qs 6c]
ToniMarteens: folds
Luckers712: folds
safelifetop: folds
whiteruss125: raises €0.04 to €0.06
kingdjass972: folds
javimagnu: folds
Uncalled bet (€0.04) returned to whiteruss125
whiteruss125 collected €0.05 from pot
whiteruss125: doesn't show hand
*** SUMMARY ***
Total pot €0.05 | Rake €0
Seat 1: whiteruss125 (button) collected (€0.05)
Seat 2: kingdjass972 (small blind) folded before Flop
Seat 3: javimagnu (big blind) folded before Flop
Seat 4: ToniMarteens folded before Flop (didn't bet)
Seat 5: Luckers712 folded before Flop (didn't bet)
Seat 6: safelifetop folded before Flop (didn't bet)



PokerStars Zoom Hand #210168551643:  Hold'em No Limit (€0.01/€0.02) - 2020/03/15 19:07:27 CET [2020/03/15 14:07:27 ET]
Table 'Arneb' 6-max Seat #1 is the button
Seat 1: raptureman1 (€2 in chips)
Seat 2: Luckers712 (€2.66 in chips)
Seat 3: chiwas12 (€2.40 in chips)
Seat 4: addata (€1.54 in chips)
Seat 5: lucky13re (€2.79 in chips)
Seat 6: trakson (€3.22 in chips)
Luckers712: posts small blind €0.01
chiwas12: posts big blind €0.02
*** HOLE CARDS ***
Dealt to Luckers712 [9c 6c]
addata: folds
lucky13re: raises €0.04 to €0.06
trakson: calls €0.06
raptureman1: folds
Luckers712: folds
chiwas12: folds
*** FLOP *** [4d Tc Ts]
lucky13re: checks
trakson: bets €0.05
lucky13re: folds
Uncalled bet (€0.05) returned to trakson
trakson collected €0.14 from pot
trakson: doesn't show hand
*** SUMMARY ***
Total pot €0.15 | Rake €0.01
Board [4d Tc Ts]
Seat 1: raptureman1 (button) folded before Flop (didn't bet)
Seat 2: Luckers712 (small blind) folded before Flop
Seat 3: chiwas12 (big blind) folded before Flop
Seat 4: addata folded before Flop (didn't bet)
Seat 5: lucky13re folded on the Flop
Seat 6: trakson collected (€0.14)



PokerStars Zoom Hand #210168565852:  Hold'em No Limit (€0.01/€0.02) - 2020/03/15 19:07:42 CET [2020/03/15 14:07:42 ET]
Table 'Arneb' 6-max Seat #1 is the button
Seat 1: lusto09 (€5.34 in chips)
Seat 2: tetar1000d (€2.05 in chips)
Seat 3: colibri1026 (€1 in chips)
Seat 4: Menorqui (€4.83 in chips)
Seat 5: Fel a Las (€2.57 in chips)
Seat 6: Luckers712 (€2.65 in chips)
tetar1000d: posts small blind €0.01
colibri1026: posts big blind €0.02
*** HOLE CARDS ***
Dealt to Luckers712 [Ad Js]
Menorqui: folds
Fel a Las: raises €0.04 to €0.06
Luckers712: calls €0.06
lusto09: folds
tetar1000d: calls €0.05
colibri1026: calls €0.04
*** FLOP *** [2c 9h 6c]
tetar1000d: checks
colibri1026: bets €0.06
Fel a Las: calls €0.06
Luckers712: folds
tetar1000d: folds
*** TURN *** [2c 9h 6c] [Jh]
colibri1026: bets €0.16
Fel a Las: calls €0.16
*** RIVER *** [2c 9h 6c Jh] [9d]
colibri1026: bets €0.22
Fel a Las: calls €0.22
*** SHOW DOWN ***
colibri1026: shows [Tc 2d] (two pair, Nines and Deuces)
Fel a Las: mucks hand
colibri1026 collected €1.06 from pot
*** SUMMARY ***
Total pot €1.12 | Rake €0.06
Board [2c 9h 6c Jh 9d]
Seat 1: lusto09 (button) folded before Flop (didn't bet)
Seat 2: tetar1000d (small blind) folded on the Flop
Seat 3: colibri1026 (big blind) showed [Tc 2d] and won (€1.06) with two pair, Nines and Deuces
Seat 4: Menorqui folded before Flop (didn't bet)
Seat 5: Fel a Las mucked [As Ks]
Seat 6: Luckers712 folded on the Flop



PokerStars Zoom Hand #210168617570:  Hold'em No Limit (€0.01/€0.02) - 2020/03/15 19:08:37 CET [2020/03/15 14:08:37 ET]
Table 'Arneb' 6-max Seat #1 is the button
Seat 1: PatrickVence (€2.91 in chips)
Seat 2: pabmesa (€2.70 in chips)
Seat 3: Luckers712 (€2.59 in chips)
Seat 4: unounoporfavor (€6.45 in chips)
Seat 5: iker138 (€1.05 in chips)
Seat 6: TJDasNeves (€2.19 in chips)
pabmesa: posts small blind €0.01
Luckers712: posts big blind €0.02
*** HOLE CARDS ***
Dealt to Luckers712 [3s Js]
unounoporfavor: folds
iker138: folds
TJDasNeves: folds
PatrickVence: raises €0.05 to €0.07
pabmesa: folds
Luckers712: folds
Uncalled bet (€0.05) returned to PatrickVence
PatrickVence collected €0.05 from pot
PatrickVence: doesn't show hand
*** SUMMARY ***
Total pot €0.05 | Rake €0
Seat 1: PatrickVence (button) collected (€0.05)
Seat 2: pabmesa (small blind) folded before Flop
Seat 3: Luckers712 (big blind) folded before Flop
Seat 4: unounoporfavor folded before Flop (didn't bet)
Seat 5: iker138 folded before Flop (didn't bet)
Seat 6: TJDasNeves folded before Flop (didn't bet)



PokerStars Zoom Hand #210168635489:  Hold'em No Limit (€0.01/€0.02) - 2020/03/15 19:08:56 CET [2020/03/15 14:08:56 ET]
Table 'Arneb' 6-max Seat #1 is the button
Seat 1: chiwas12 (€3.94 in chips)
Seat 2: 00Spidy00 (€2.15 in chips)
Seat 3: The dead97 (€3.01 in chips)
Seat 4: Capitan Aab (€2.04 in chips)
Seat 5: Luckers712 (€2.57 in chips)
Seat 6: bilboubou78 (€1.97 in chips)
00Spidy00: posts small blind €0.01
The dead97: posts big blind €0.02
*** HOLE CARDS ***
Dealt to Luckers712 [5c 4s]
Capitan Aab: raises €0.02 to €0.04
Luckers712: folds
bilboubou78: folds
chiwas12: folds
00Spidy00: folds
The dead97: folds
Uncalled bet (€0.02) returned to Capitan Aab
Capitan Aab collected €0.05 from pot
Capitan Aab: doesn't show hand
*** SUMMARY ***
Total pot €0.05 | Rake €0
Seat 1: chiwas12 (button) folded before Flop (didn't bet)
Seat 2: 00Spidy00 (small blind) folded before Flop
Seat 3: The dead97 (big blind) folded before Flop
Seat 4: Capitan Aab collected (€0.05)
Seat 5: Luckers712 folded before Flop (didn't bet)
Seat 6: bilboubou78 folded before Flop (didn't bet)



PokerStars Zoom Hand #210168641005:  Hold'em No Limit (€0.01/€0.02) - 2020/03/15 19:09:02 CET [2020/03/15 14:09:02 ET]
Table 'Arneb' 6-max Seat #1 is the button
Seat 1: nick4tech (€5.77 in chips)
Seat 2: Vitorero (€2.08 in chips)
Seat 3: llodio (€2.31 in chips)
Seat 4: Luckers712 (€2.57 in chips)
Seat 5: Cangrejocotyx (€0.71 in chips)
Seat 6: o1o0o1o (€4.98 in chips)
Vitorero: posts small blind €0.01
llodio: posts big blind €0.02
*** HOLE CARDS ***
Dealt to Luckers712 [9s Js]
Luckers712: folds
Cangrejocotyx: folds
o1o0o1o: raises €0.06 to €0.08
nick4tech: raises €0.16 to €0.24
Vitorero: folds
llodio: folds
o1o0o1o: calls €0.16
*** FLOP *** [6d 8h Jh]
o1o0o1o: checks
nick4tech: checks
*** TURN *** [6d 8h Jh] [2s]
o1o0o1o: checks
nick4tech: checks
*** RIVER *** [6d 8h Jh 2s] [3c]
o1o0o1o: checks
nick4tech: checks
*** SHOW DOWN ***
o1o0o1o: shows [Ts Tc] (a pair of Tens)
nick4tech: mucks hand
o1o0o1o collected €0.48 from pot
*** SUMMARY ***
Total pot €0.51 | Rake €0.03
Board [6d 8h Jh 2s 3c]
Seat 1: nick4tech (button) mucked [Ad Qd]
Seat 2: Vitorero (small blind) folded before Flop
Seat 3: llodio (big blind) folded before Flop
Seat 4: Luckers712 folded before Flop (didn't bet)
Seat 5: Cangrejocotyx folded before Flop (didn't bet)
Seat 6: o1o0o1o showed [Ts Tc] and won (€0.48) with a pair of Tens



PokerStars Zoom Hand #210168653291:  Hold'em No Limit (€0.01/€0.02) - 2020/03/15 19:09:15 CET [2020/03/15 14:09:15 ET]
Table 'Arneb' 6-max Seat #1 is the button
Seat 1: llodio (€2.29 in chips)
Seat 2: Dark_make632 (€2.57 in chips)
Seat 3: chiwas12 (€3.94 in chips)
Seat 4: cocololo91 (€6.38 in chips)
Seat 5: addata (€1.39 in chips)
Seat 6: Luckers712 (€2.57 in chips)
Dark_make632: posts small blind €0.01
chiwas12: posts big blind €0.02
*** HOLE CARDS ***
Dealt to Luckers712 [Qs 6d]
cocololo91: folds
addata: folds
Luckers712: folds
llodio: folds
Dark_make632: raises €0.03 to €0.05
chiwas12: folds
Uncalled bet (€0.03) returned to Dark_make632
Dark_make632 collected €0.04 from pot
Dark_make632: doesn't show hand
*** SUMMARY ***
Total pot €0.04 | Rake €0
Seat 1: llodio (button) folded before Flop (didn't bet)
Seat 2: Dark_make632 (small blind) collected (€0.04)
Seat 3: chiwas12 (big blind) folded before Flop
Seat 4: cocololo91 folded before Flop (didn't bet)
Seat 5: addata folded before Flop (didn't bet)
Seat 6: Luckers712 folded before Flop (didn't bet)



PokerStars Zoom Hand #210168658974:  Hold'em No Limit (€0.01/€0.02) - 2020/03/15 19:09:21 CET [2020/03/15 14:09:21 ET]
Table 'Arneb' 6-max Seat #1 is the button
Seat 1: ciclo230385 (€2 in chips)
Seat 2: enbr27 (€2.10 in chips)
Seat 3: ivan_ojuelo (€2 in chips)
Seat 4: Luckers712 (€2.57 in chips)
Seat 5: KANDANSKY (€3.36 in chips)
Seat 6: javimagnu (€2.02 in chips)
enbr27: posts small blind €0.01
ivan_ojuelo: posts big blind €0.02
*** HOLE CARDS ***
Dealt to Luckers712 [2h 9d]
Luckers712: folds
KANDANSKY: raises €0.02 to €0.04
javimagnu: folds
ciclo230385: folds
enbr27: folds
ivan_ojuelo: folds
Uncalled bet (€0.02) returned to KANDANSKY
KANDANSKY collected €0.05 from pot
KANDANSKY: doesn't show hand
*** SUMMARY ***
Total pot €0.05 | Rake €0
Seat 1: ciclo230385 (button) folded before Flop (didn't bet)
Seat 2: enbr27 (small blind) folded before Flop
Seat 3: ivan_ojuelo (big blind) folded before Flop
Seat 4: Luckers712 folded before Flop (didn't bet)
Seat 5: KANDANSKY collected (€0.05)
Seat 6: javimagnu folded before Flop (didn't bet)



PokerStars Zoom Hand #210168663688:  Hold'em No Limit (€0.01/€0.02) - 2020/03/15 19:09:26 CET [2020/03/15 14:09:26 ET]
Table 'Arneb' 6-max Seat #1 is the button
Seat 1: PITI1231 (€2 in chips)
Seat 2: Luckers712 (€2.57 in chips)
Seat 3: PepitoGrillo24 (€2 in chips)
Seat 4: crrio (€3.59 in chips)
Seat 5: Sánchez63 (€0.48 in chips)
Seat 6: Vitorero (€2.07 in chips)
Luckers712: posts small blind €0.01
PepitoGrillo24: posts big blind €0.02
*** HOLE CARDS ***
Dealt to Luckers712 [4c 3h]
crrio: folds
Sánchez63: raises €0.04 to €0.06
Vitorero: folds
PITI1231: folds
Luckers712: folds
PepitoGrillo24: folds
Uncalled bet (€0.04) returned to Sánchez63
Sánchez63 collected €0.05 from pot
Sánchez63: doesn't show hand
*** SUMMARY ***
Total pot €0.05 | Rake €0
Seat 1: PITI1231 (button) folded before Flop (didn't bet)
Seat 2: Luckers712 (small blind) folded before Flop
Seat 3: PepitoGrillo24 (big blind) folded before Flop
Seat 4: crrio folded before Flop (didn't bet)
Seat 5: Sánchez63 collected (€0.05)
Seat 6: Vitorero folded before Flop (didn't bet)



PokerStars Zoom Hand #210168667410:  Hold'em No Limit (€0.01/€0.02) - 2020/03/15 19:09:30 CET [2020/03/15 14:09:30 ET]
Table 'Arneb' 6-max Seat #1 is the button
Seat 1: martingete (€1.97 in chips)
Seat 2: Vitorhcsousa (€2 in chips)
Seat 3: Luckers712 (€2.56 in chips)
Seat 4: javigarrido8 (€1.97 in chips)
Seat 5: 33TUIGA33 (€1.35 in chips)
Seat 6: Kayfidze (€3.03 in chips)
Vitorhcsousa: posts small blind €0.01
Luckers712: posts big blind €0.02
*** HOLE CARDS ***
Dealt to Luckers712 [As Ac]
javigarrido8: folds
33TUIGA33: folds
Kayfidze: folds
martingete: folds
Vitorhcsousa: folds
Uncalled bet (€0.01) returned to Luckers712
Luckers712 collected €0.02 from pot
Luckers712: doesn't show hand
*** SUMMARY ***
Total pot €0.02 | Rake €0
Seat 1: martingete (button) folded before Flop (didn't bet)
Seat 2: Vitorhcsousa (small blind) folded before Flop
Seat 3: Luckers712 (big blind) collected (€0.02)
Seat 4: javigarrido8 folded before Flop (didn't bet)
Seat 5: 33TUIGA33 folded before Flop (didn't bet)
Seat 6: Kayfidze folded before Flop (didn't bet)



PokerStars Zoom Hand #210168646604:  Hold'em No Limit (€0.01/€0.02) - 2020/03/15 19:09:08 CET [2020/03/15 14:09:08 ET]
Table 'Arneb' 6-max Seat #1 is the button
Seat 1: M5dias (€2.84 in chips)
Seat 2: vatol0co (€1.06 in chips)
Seat 3: saulb16 (€2.05 in chips)
Seat 4: Luckers712 (€2.57 in chips)
Seat 5: javigarrido8 (€1.97 in chips)
Seat 6: tunningboy67 (€1.66 in chips)
vatol0co: posts small blind €0.01
saulb16: posts big blind €0.02
*** HOLE CARDS ***
Dealt to Luckers712 [Tc 3c]
Luckers712: folds
javigarrido8: folds
tunningboy67: raises €0.02 to €0.04
M5dias: raises €0.08 to €0.12
vatol0co: folds
saulb16: folds
tunningboy67: calls €0.08
*** FLOP *** [Th 6s 6c]
tunningboy67: checks
M5dias: checks
*** TURN *** [Th 6s 6c] [8h]
tunningboy67: checks
M5dias: bets €0.13
tunningboy67: calls €0.13
*** RIVER *** [Th 6s 6c 8h] [5c]
tunningboy67: bets €0.40
M5dias: calls €0.40
*** SHOW DOWN ***
tunningboy67: shows [6d 5d] (a full house, Sixes full of Fives)
M5dias: mucks hand
tunningboy67 collected €1.26 from pot
*** SUMMARY ***
Total pot €1.33 | Rake €0.07
Board [Th 6s 6c 8h 5c]
Seat 1: M5dias (button) mucked [Kd Kc]
Seat 2: vatol0co (small blind) folded before Flop
Seat 3: saulb16 (big blind) folded before Flop
Seat 4: Luckers712 folded before Flop (didn't bet)
Seat 5: javigarrido8 folded before Flop (didn't bet)
Seat 6: tunningboy67 showed [6d 5d] and won (€1.26) with a full house, Sixes full of Fives



PokerStars Zoom Hand #210168650445:  Hold'em No Limit (€0.01/€0.02) - 2020/03/15 19:09:12 CET [2020/03/15 14:09:12 ET]
Table 'Arneb' 6-max Seat #1 is the button
Seat 1: Luckers712 (€2.57 in chips)
Seat 2: Ballagarey (€2.07 in chips)
Seat 3: 45stream (€2.77 in chips)
Seat 4: ricmp (€4.57 in chips)
Seat 5: Anme41 (€1.95 in chips)
Seat 6: jacksparr485 (€2.06 in chips)
Ballagarey: posts small blind €0.01
45stream: posts big blind €0.02
*** HOLE CARDS ***
Dealt to Luckers712 [5d 2d]
ricmp: folds
Anme41: folds
jacksparr485: raises €0.04 to €0.06
Luckers712: folds
Ballagarey: folds
45stream: calls €0.04
*** FLOP *** [8c 4h Qc]
45stream: checks
jacksparr485: bets €0.06
45stream: calls €0.06
*** TURN *** [8c 4h Qc] [4d]
45stream: checks
jacksparr485: bets €0.18
45stream: calls €0.18
*** RIVER *** [8c 4h Qc 4d] [Qd]
45stream: checks
jacksparr485: bets €0.44
45stream: raises €1.27 to €1.71
jacksparr485: raises €0.05 to €1.76 and is all-in
45stream: calls €0.05
*** SHOW DOWN ***
jacksparr485: shows [Qh Jc] (a full house, Queens full of Fours)
45stream: shows [Qs Jh] (a full house, Queens full of Fours)
45stream collected €1.96 from pot
jacksparr485 collected €1.96 from pot
*** SUMMARY ***
Total pot €4.13 | Rake €0.21
Board [8c 4h Qc 4d Qd]
Seat 1: Luckers712 (button) folded before Flop (didn't bet)
Seat 2: Ballagarey (small blind) folded before Flop
Seat 3: 45stream (big blind) showed [Qs Jh] and won (€1.96) with a full house, Queens full of Fours
Seat 4: ricmp folded before Flop (didn't bet)
Seat 5: Anme41 folded before Flop (didn't bet)
Seat 6: jacksparr485 showed [Qh Jc] and won (€1.96) with a full house, Queens full of Fours



PokerStars Zoom Hand #210168681573:  Hold'em No Limit (€0.01/€0.02) - 2020/03/15 19:09:45 CET [2020/03/15 14:09:45 ET]
Table 'Arneb' 6-max Seat #1 is the button
Seat 1: Luckers712 (€2.57 in chips)
Seat 2: Veesile (€2.01 in chips)
Seat 3: NanoLMP (€3.40 in chips)
Seat 4: Markitos PT (€3.05 in chips)
Seat 5: ElvasSniper (€2.03 in chips)
Seat 6: chiwas12 (€2.01 in chips)
Veesile: posts small blind €0.01
NanoLMP: posts big blind €0.02
*** HOLE CARDS ***
Dealt to Luckers712 [Ah 9h]
Markitos PT: folds
ElvasSniper: folds
chiwas12: raises €0.03 to €0.05
Luckers712: calls €0.05
Veesile: folds
NanoLMP: folds
*** FLOP *** [Qd Js 4h]
chiwas12: checks
Luckers712: checks
*** TURN *** [Qd Js 4h] [7s]
chiwas12: checks
Luckers712: checks
*** RIVER *** [Qd Js 4h 7s] [8c]
chiwas12: checks
Luckers712: checks
*** SHOW DOWN ***
chiwas12: shows [3c 3s] (a pair of Threes)
Luckers712: mucks hand
chiwas12 collected €0.12 from pot
*** SUMMARY ***
Total pot €0.13 | Rake €0.01
Board [Qd Js 4h 7s 8c]
Seat 1: Luckers712 (button) mucked [Ah 9h]
Seat 2: Veesile (small blind) folded before Flop
Seat 3: NanoLMP (big blind) folded before Flop
Seat 4: Markitos PT folded before Flop (didn't bet)
Seat 5: ElvasSniper folded before Flop (didn't bet)
Seat 6: chiwas12 showed [3c 3s] and won (€0.12) with a pair of Threes



PokerStars Zoom Hand #210168715564:  Hold'em No Limit (€0.01/€0.02) - 2020/03/15 19:10:21 CET [2020/03/15 14:10:21 ET]
Table 'Arneb' 6-max Seat #1 is the button
Seat 1: XXXMJA (€2 in chips)
Seat 2: Synestr0 (€2.15 in chips)
Seat 3: amanso (€2.14 in chips)
Seat 4: Kayfidze (€3.61 in chips)
Seat 5: jacksparr485 (€2 in chips)
Seat 6: Luckers712 (€2.52 in chips)
Synestr0: posts small blind €0.01
amanso: posts big blind €0.02
*** HOLE CARDS ***
Dealt to Luckers712 [3s 2h]
Kayfidze: folds
jacksparr485: folds
Luckers712: folds
XXXMJA: folds
Synestr0: folds
Uncalled bet (€0.01) returned to amanso
amanso collected €0.02 from pot
amanso: doesn't show hand
*** SUMMARY ***
Total pot €0.02 | Rake €0
Seat 1: XXXMJA (button) folded before Flop (didn't bet)
Seat 2: Synestr0 (small blind) folded before Flop
Seat 3: amanso (big blind) collected (€0.02)
Seat 4: Kayfidze folded before Flop (didn't bet)
Seat 5: jacksparr485 folded before Flop (didn't bet)
Seat 6: Luckers712 folded before Flop (didn't bet)



PokerStars Zoom Hand #210168726735:  Hold'em No Limit (€0.01/€0.02) - 2020/03/15 19:10:33 CET [2020/03/15 14:10:33 ET]
Table 'Arneb' 6-max Seat #1 is the button
Seat 1: lucky13re (€2 in chips)
Seat 2: raptureman1 (€2 in chips)
Seat 3: NanoLMP (€2.41 in chips)
Seat 4: galodebarcelos (€2.40 in chips)
Seat 5: Luckers712 (€2.50 in chips)
Seat 6: campanilla06 (€1.95 in chips)
raptureman1: posts small blind €0.01
NanoLMP: posts big blind €0.02
*** HOLE CARDS ***
Dealt to Luckers712 [2h 6s]
galodebarcelos: raises €0.04 to €0.06
Luckers712: folds
campanilla06: calls €0.06
lucky13re: folds
raptureman1: raises €0.20 to €0.26
NanoLMP: folds
galodebarcelos: folds
campanilla06: folds
Uncalled bet (€0.20) returned to raptureman1
raptureman1 collected €0.20 from pot
raptureman1: doesn't show hand
*** SUMMARY ***
Total pot €0.20 | Rake €0
Seat 1: lucky13re (button) folded before Flop (didn't bet)
Seat 2: raptureman1 (small blind) collected (€0.20)
Seat 3: NanoLMP (big blind) folded before Flop
Seat 4: galodebarcelos folded before Flop
Seat 5: Luckers712 folded before Flop (didn't bet)
Seat 6: campanilla06 folded before Flop



PokerStars Zoom Hand #210168731421:  Hold'em No Limit (€0.01/€0.02) - 2020/03/15 19:10:38 CET [2020/03/15 14:10:38 ET]
Table 'Arneb' 6-max Seat #1 is the button
Seat 1: addata (€1.31 in chips)
Seat 2: Luckers712 (€2.50 in chips)
Seat 3: llodio (€2.26 in chips)
Seat 4: Kayfidze (€2.58 in chips)
Seat 5: ivan_ojuelo (€1.92 in chips)
Seat 6: El moro78 (€2.37 in chips)
Luckers712: posts small blind €0.01
llodio: posts big blind €0.02
*** HOLE CARDS ***
Dealt to Luckers712 [Ts 8s]
Kayfidze: folds
ivan_ojuelo: folds
El moro78: raises €0.04 to €0.06
addata: folds
Luckers712: raises €0.14 to €0.20
llodio: folds
El moro78: folds
Uncalled bet (€0.14) returned to Luckers712
Luckers712 collected €0.14 from pot
Luckers712: doesn't show hand
*** SUMMARY ***
Total pot €0.14 | Rake €0
Seat 1: addata (button) folded before Flop (didn't bet)
Seat 2: Luckers712 (small blind) collected (€0.14)
Seat 3: llodio (big blind) folded before Flop
Seat 4: Kayfidze folded before Flop (didn't bet)
Seat 5: ivan_ojuelo folded before Flop (didn't bet)
Seat 6: El moro78 folded before Flop



PokerStars Zoom Hand #210168719364:  Hold'em No Limit (€0.01/€0.02) - 2020/03/15 19:10:25 CET [2020/03/15 14:10:25 ET]
Table 'Arneb' 6-max Seat #1 is the button
Seat 1: Karpiniano (€2.90 in chips)
Seat 2: lusto09 (€5.06 in chips)
Seat 3: Luckers712 (€2.52 in chips)
Seat 4: jmaigre (€0.71 in chips)
Seat 5: triatlon23 (€2 in chips)
Seat 6: bpbernardo (€1.96 in chips)
lusto09: posts small blind €0.01
Luckers712: posts big blind €0.02
*** HOLE CARDS ***
Dealt to Luckers712 [Qc 5h]
jmaigre: folds
triatlon23: folds
bpbernardo: folds
Karpiniano: raises €0.03 to €0.05
lusto09: calls €0.04
Luckers712: folds
*** FLOP *** [8d 2h Tc]
lusto09: checks
Karpiniano: bets €0.04
lusto09: calls €0.04
*** TURN *** [8d 2h Tc] [6s]
lusto09: checks
Karpiniano: checks
*** RIVER *** [8d 2h Tc 6s] [7h]
lusto09: bets €0.13
Karpiniano: folds
Uncalled bet (€0.13) returned to lusto09
lusto09 collected €0.19 from pot
lusto09: doesn't show hand
*** SUMMARY ***
Total pot €0.20 | Rake €0.01
Board [8d 2h Tc 6s 7h]
Seat 1: Karpiniano (button) folded on the River
Seat 2: lusto09 (small blind) collected (€0.19)
Seat 3: Luckers712 (big blind) folded before Flop
Seat 4: jmaigre folded before Flop (didn't bet)
Seat 5: triatlon23 folded before Flop (didn't bet)
Seat 6: bpbernardo folded before Flop (didn't bet)



PokerStars Zoom Hand #210168774741:  Hold'em No Limit (€0.01/€0.02) - 2020/03/15 19:11:24 CET [2020/03/15 14:11:24 ET]
Table 'Arneb' 6-max Seat #1 is the button
Seat 1: TJDasNeves (€4.21 in chips)
Seat 2: bilboubou78 (€2.87 in chips)
Seat 3: lusto09 (€5.16 in chips)
Seat 4: Luckers712 (€2.58 in chips)
Seat 5: Dark_make632 (€2.54 in chips)
Seat 6: M5dias (€3.89 in chips)
bilboubou78: posts small blind €0.01
lusto09: posts big blind €0.02
*** HOLE CARDS ***
Dealt to Luckers712 [6c 5c]
Luckers712: folds
Dark_make632: folds
M5dias: folds
TJDasNeves: folds
bilboubou78: raises €0.04 to €0.06
lusto09: folds
Uncalled bet (€0.04) returned to bilboubou78
bilboubou78 collected €0.04 from pot
bilboubou78: doesn't show hand
*** SUMMARY ***
Total pot €0.04 | Rake €0
Seat 1: TJDasNeves (button) folded before Flop (didn't bet)
Seat 2: bilboubou78 (small blind) collected (€0.04)
Seat 3: lusto09 (big blind) folded before Flop
Seat 4: Luckers712 folded before Flop (didn't bet)
Seat 5: Dark_make632 folded before Flop (didn't bet)
Seat 6: M5dias folded before Flop (didn't bet)



PokerStars Zoom Hand #210168770011:  Hold'em No Limit (€0.01/€0.02) - 2020/03/15 19:11:19 CET [2020/03/15 14:11:19 ET]
Table 'Arneb' 6-max Seat #1 is the button
Seat 1: jojoo421 (€0.88 in chips)
Seat 2: KALASH71 (€1.52 in chips)
Seat 3: Jou"Yonfa$" (€3.78 in chips)
Seat 4: petitgold (€2 in chips)
Seat 5: Luckers712 (€2.58 in chips)
Seat 6: ciclo230385 (€2 in chips)
KALASH71: posts small blind €0.01
Jou"Yonfa$": posts big blind €0.02
*** HOLE CARDS ***
Dealt to Luckers712 [7h 9h]
petitgold: folds
Luckers712: folds
ciclo230385: folds
jojoo421: calls €0.02
KALASH71: folds
Jou"Yonfa$": checks
*** FLOP *** [3d 6s 5s]
Jou"Yonfa$": bets €0.02
jojoo421: raises €0.02 to €0.04
Jou"Yonfa$": folds
Uncalled bet (€0.02) returned to jojoo421
jojoo421 collected €0.09 from pot
jojoo421: doesn't show hand
*** SUMMARY ***
Total pot €0.09 | Rake €0
Board [3d 6s 5s]
Seat 1: jojoo421 (button) collected (€0.09)
Seat 2: KALASH71 (small blind) folded before Flop
Seat 3: Jou"Yonfa$" (big blind) folded on the Flop
Seat 4: petitgold folded before Flop (didn't bet)
Seat 5: Luckers712 folded before Flop (didn't bet)
Seat 6: ciclo230385 folded before Flop (didn't bet)



PokerStars Zoom Hand #210168765253:  Hold'em No Limit (€0.01/€0.02) - 2020/03/15 19:11:14 CET [2020/03/15 14:11:14 ET]
Table 'Arneb' 6-max Seat #1 is the button
Seat 1: albertito151 (€3.52 in chips)
Seat 2: thehunterfox (€2.40 in chips)
Seat 3: camaliao (€1.36 in chips)
Seat 4: Westlm01 (€2.24 in chips)
Seat 5: Comlan22 (€2.31 in chips)
Seat 6: Luckers712 (€2.58 in chips)
thehunterfox: posts small blind €0.01
camaliao: posts big blind €0.02
*** HOLE CARDS ***
Dealt to Luckers712 [8h 9d]
Westlm01: folds
Comlan22: folds
Luckers712: folds
albertito151: raises €0.04 to €0.06
thehunterfox: calls €0.05
camaliao: calls €0.04
*** FLOP *** [4s Kh Qs]
thehunterfox: bets €0.08
camaliao: calls €0.08
albertito151: folds
*** TURN *** [4s Kh Qs] [Qc]
thehunterfox: checks
camaliao: checks
*** RIVER *** [4s Kh Qs Qc] [7c]
thehunterfox: checks
camaliao: bets €0.16
thehunterfox: folds
Uncalled bet (€0.16) returned to camaliao
camaliao collected €0.32 from pot
camaliao: doesn't show hand
*** SUMMARY ***
Total pot €0.34 | Rake €0.02
Board [4s Kh Qs Qc 7c]
Seat 1: albertito151 (button) folded on the Flop
Seat 2: thehunterfox (small blind) folded on the River
Seat 3: camaliao (big blind) collected (€0.32)
Seat 4: Westlm01 folded before Flop (didn't bet)
Seat 5: Comlan22 folded before Flop (didn't bet)
Seat 6: Luckers712 folded before Flop (didn't bet)



PokerStars Zoom Hand #210168779360:  Hold'em No Limit (€0.01/€0.02) - 2020/03/15 19:11:29 CET [2020/03/15 14:11:29 ET]
Table 'Arneb' 6-max Seat #1 is the button
Seat 1: galodebarcelos (€2.20 in chips)
Seat 2: Luckers712 (€2.58 in chips)
Seat 3: jparrasa (€2 in chips)
Seat 4: MMMJLMALM (€1.36 in chips)
Seat 5: chiwas12 (€2.08 in chips)
Seat 6: Comino79 (€1.77 in chips)
Luckers712: posts small blind €0.01
jparrasa: posts big blind €0.02
*** HOLE CARDS ***
Dealt to Luckers712 [Ac Th]
MMMJLMALM: folds
chiwas12: folds
Comino79: folds
galodebarcelos: raises €0.02 to €0.04
Luckers712: calls €0.03
jparrasa: folds
*** FLOP *** [5h 9s 8c]
Luckers712: checks
galodebarcelos: bets €0.07
Luckers712: calls €0.07
*** TURN *** [5h 9s 8c] [6d]
Luckers712: checks
galodebarcelos: checks
*** RIVER *** [5h 9s 8c 6d] [5d]
Luckers712: checks
galodebarcelos: bets €0.16
Luckers712: folds
Uncalled bet (€0.16) returned to galodebarcelos
galodebarcelos collected €0.23 from pot
galodebarcelos: doesn't show hand
*** SUMMARY ***
Total pot €0.24 | Rake €0.01
Board [5h 9s 8c 6d 5d]
Seat 1: galodebarcelos (button) collected (€0.23)
Seat 2: Luckers712 (small blind) folded on the River
Seat 3: jparrasa (big blind) folded before Flop
Seat 4: MMMJLMALM folded before Flop (didn't bet)
Seat 5: chiwas12 folded before Flop (didn't bet)
Seat 6: Comino79 folded before Flop (didn't bet)



PokerStars Zoom Hand #210168834457:  Hold'em No Limit (€0.01/€0.02) - 2020/03/15 19:12:28 CET [2020/03/15 14:12:28 ET]
Table 'Arneb' 6-max Seat #1 is the button
Seat 1: Luckers712 (€2.47 in chips)
Seat 2: 00Spidy00 (€2.63 in chips)
Seat 3: DNooXLvv (€3.99 in chips)
Seat 4: dreamer11111 (€2.14 in chips)
Seat 5: mounty22333 (€4.14 in chips)
Seat 6: ElvasSniper (€2 in chips)
00Spidy00: posts small blind €0.01
DNooXLvv: posts big blind €0.02
*** HOLE CARDS ***
Dealt to Luckers712 [9h As]
dreamer11111: raises €0.04 to €0.06
mounty22333: raises €0.04 to €0.10
ElvasSniper: folds
Luckers712: folds
00Spidy00: folds
DNooXLvv: folds
dreamer11111: folds
Uncalled bet (€0.04) returned to mounty22333
mounty22333 collected €0.15 from pot
mounty22333: doesn't show hand
*** SUMMARY ***
Total pot €0.15 | Rake €0
Seat 1: Luckers712 (button) folded before Flop (didn't bet)
Seat 2: 00Spidy00 (small blind) folded before Flop
Seat 3: DNooXLvv (big blind) folded before Flop
Seat 4: dreamer11111 folded before Flop
Seat 5: mounty22333 collected (€0.15)
Seat 6: ElvasSniper folded before Flop (didn't bet)



PokerStars Zoom Hand #210168845535:  Hold'em No Limit (€0.01/€0.02) - 2020/03/15 19:12:40 CET [2020/03/15 14:12:40 ET]
Table 'Arneb' 6-max Seat #1 is the button
Seat 1: mugen1928 (€3.24 in chips)
Seat 2: cad1959 (€2.68 in chips)
Seat 3: Luckers712 (€2.47 in chips)
Seat 4: ordisile (€2.17 in chips)
Seat 5: 00Spidy00 (€2.62 in chips)
Seat 6: Cangrejocotyx (€1.34 in chips)
cad1959: posts small blind €0.01
Luckers712: posts big blind €0.02
*** HOLE CARDS ***
Dealt to Luckers712 [7c 3d]
ordisile: folds
00Spidy00: folds
Cangrejocotyx: raises €0.04 to €0.06
mugen1928: folds
cad1959: folds
Luckers712: folds
Uncalled bet (€0.04) returned to Cangrejocotyx
Cangrejocotyx collected €0.05 from pot
Cangrejocotyx: doesn't show hand
*** SUMMARY ***
Total pot €0.05 | Rake €0
Seat 1: mugen1928 (button) folded before Flop (didn't bet)
Seat 2: cad1959 (small blind) folded before Flop
Seat 3: Luckers712 (big blind) folded before Flop
Seat 4: ordisile folded before Flop (didn't bet)
Seat 5: 00Spidy00 folded before Flop (didn't bet)
Seat 6: Cangrejocotyx collected (€0.05)



PokerStars Zoom Hand #210168853161:  Hold'em No Limit (€0.01/€0.02) - 2020/03/15 19:12:48 CET [2020/03/15 14:12:48 ET]
Table 'Arneb' 6-max Seat #1 is the button
Seat 1: Fredus73 (€4.66 in chips)
Seat 2: wilmar20 (€2 in chips)
Seat 3: lucky13re (€2.16 in chips)
Seat 4: iker138 (€1.41 in chips)
Seat 5: ekzemaker (€7.45 in chips)
Seat 6: Luckers712 (€2.45 in chips)
wilmar20: posts small blind €0.01
lucky13re: posts big blind €0.02
*** HOLE CARDS ***
Dealt to Luckers712 [6s 6d]
iker138: folds
ekzemaker: folds
Luckers712: raises €0.03 to €0.05
Fredus73: folds
wilmar20: folds
lucky13re: folds
Uncalled bet (€0.03) returned to Luckers712
Luckers712 collected €0.05 from pot
Luckers712: doesn't show hand
*** SUMMARY ***
Total pot €0.05 | Rake €0
Seat 1: Fredus73 (button) folded before Flop (didn't bet)
Seat 2: wilmar20 (small blind) folded before Flop
Seat 3: lucky13re (big blind) folded before Flop
Seat 4: iker138 folded before Flop (didn't bet)
Seat 5: ekzemaker folded before Flop (didn't bet)
Seat 6: Luckers712 collected (€0.05)



PokerStars Zoom Hand #210168841844:  Hold'em No Limit (€0.01/€0.02) - 2020/03/15 19:12:36 CET [2020/03/15 14:12:36 ET]
Table 'Arneb' 6-max Seat #1 is the button
Seat 1: o1o0o1o (€2.16 in chips)
Seat 2: Toldos140 (€4.30 in chips)
Seat 3: Alex2140Alex (€0.65 in chips)
Seat 4: Luckers712 (€2.47 in chips)
Seat 5: Menorqui (€4.71 in chips)
Seat 6: 00Spidy00 (€2.62 in chips)
Toldos140: posts small blind €0.01
Alex2140Alex: posts big blind €0.02
*** HOLE CARDS ***
Dealt to Luckers712 [Ks 2c]
Luckers712: folds
Menorqui: folds
00Spidy00: folds
o1o0o1o: raises €0.02 to €0.04
Toldos140: calls €0.03
Alex2140Alex: folds
*** FLOP *** [5c 3s Jh]
Toldos140: checks
o1o0o1o: checks
*** TURN *** [5c 3s Jh] [Kh]
Toldos140: checks
o1o0o1o: checks
*** RIVER *** [5c 3s Jh Kh] [4h]
Toldos140: bets €0.06
o1o0o1o: folds
Uncalled bet (€0.06) returned to Toldos140
Toldos140 collected €0.10 from pot
Toldos140: doesn't show hand
*** SUMMARY ***
Total pot €0.10 | Rake €0
Board [5c 3s Jh Kh 4h]
Seat 1: o1o0o1o (button) folded on the River
Seat 2: Toldos140 (small blind) collected (€0.10)
Seat 3: Alex2140Alex (big blind) folded before Flop
Seat 4: Luckers712 folded before Flop (didn't bet)
Seat 5: Menorqui folded before Flop (didn't bet)
Seat 6: 00Spidy00 folded before Flop (didn't bet)



PokerStars Zoom Hand #210168874703:  Hold'em No Limit (€0.01/€0.02) - 2020/03/15 19:13:11 CET [2020/03/15 14:13:11 ET]
Table 'Arneb' 6-max Seat #1 is the button
Seat 1: trakson (€2 in chips)
Seat 2: manuelsg89 (€2.27 in chips)
Seat 3: unounoporfavor (€9.75 in chips)
Seat 4: Vitorhcsousa (€2.02 in chips)
Seat 5: Luckers712 (€2.48 in chips)
Seat 6: fcruz91 (€2.13 in chips)
manuelsg89: posts small blind €0.01
unounoporfavor: posts big blind €0.02
*** HOLE CARDS ***
Dealt to Luckers712 [2d Kh]
Vitorhcsousa: folds
Luckers712: folds
fcruz91: folds
trakson: raises €0.04 to €0.06
manuelsg89: raises €0.14 to €0.20
unounoporfavor: folds
trakson: folds
Uncalled bet (€0.14) returned to manuelsg89
manuelsg89 collected €0.14 from pot
manuelsg89: doesn't show hand
*** SUMMARY ***
Total pot €0.14 | Rake €0
Seat 1: trakson (button) folded before Flop
Seat 2: manuelsg89 (small blind) collected (€0.14)
Seat 3: unounoporfavor (big blind) folded before Flop
Seat 4: Vitorhcsousa folded before Flop (didn't bet)
Seat 5: Luckers712 folded before Flop (didn't bet)
Seat 6: fcruz91 folded before Flop (didn't bet)



PokerStars Zoom Hand #210168883105:  Hold'em No Limit (€0.01/€0.02) - 2020/03/15 19:13:20 CET [2020/03/15 14:13:20 ET]
Table 'Arneb' 6-max Seat #1 is the button
Seat 1: addata (€1.49 in chips)
Seat 2: bilboubou78 (€3.95 in chips)
Seat 3: jacksparr485 (€2 in chips)
Seat 4: mugen1928 (€3.23 in chips)
Seat 5: Séneca Magic (€8.71 in chips)
Seat 6: Luckers712 (€2.48 in chips)
bilboubou78: posts small blind €0.01
jacksparr485: posts big blind €0.02
*** HOLE CARDS ***
Dealt to Luckers712 [9c 3h]
mugen1928 has timed out
mugen1928: folds
Séneca Magic: folds
Luckers712: folds
addata: folds
bilboubou78: raises €0.04 to €0.06
jacksparr485: folds
Uncalled bet (€0.04) returned to bilboubou78
bilboubou78 collected €0.04 from pot
bilboubou78: doesn't show hand
*** SUMMARY ***
Total pot €0.04 | Rake €0
Seat 1: addata (button) folded before Flop (didn't bet)
Seat 2: bilboubou78 (small blind) collected (€0.04)
Seat 3: jacksparr485 (big blind) folded before Flop
Seat 4: mugen1928 folded before Flop (didn't bet)
Seat 5: Séneca Magic folded before Flop (didn't bet)
Seat 6: Luckers712 folded before Flop (didn't bet)



PokerStars Zoom Hand #210168878424:  Hold'em No Limit (€0.01/€0.02) - 2020/03/15 19:13:15 CET [2020/03/15 14:13:15 ET]
Table 'Arneb' 6-max Seat #1 is the button
Seat 1: Luckers712 (€2.48 in chips)
Seat 2: ThePryce (€1.78 in chips)
Seat 3: ekzemaker (€2.87 in chips)
Seat 4: portu35 (€2 in chips)
Seat 5: DNooXLvv (€3.54 in chips)
Seat 6: PITI1231 (€2.03 in chips)
ThePryce: posts small blind €0.01
ekzemaker: posts big blind €0.02
*** HOLE CARDS ***
Dealt to Luckers712 [Qd 3s]
portu35: raises €0.04 to €0.06
DNooXLvv: folds
PITI1231: folds
Luckers712: folds
ThePryce: raises €0.10 to €0.16
ekzemaker: folds
portu35: folds
Uncalled bet (€0.10) returned to ThePryce
ThePryce collected €0.14 from pot
ThePryce: doesn't show hand
*** SUMMARY ***
Total pot €0.14 | Rake €0
Seat 1: Luckers712 (button) folded before Flop (didn't bet)
Seat 2: ThePryce (small blind) collected (€0.14)
Seat 3: ekzemaker (big blind) folded before Flop
Seat 4: portu35 folded before Flop
Seat 5: DNooXLvv folded before Flop (didn't bet)
Seat 6: PITI1231 folded before Flop (didn't bet)



PokerStars Zoom Hand #210168886892:  Hold'em No Limit (€0.01/€0.02) - 2020/03/15 19:13:24 CET [2020/03/15 14:13:24 ET]
Table 'Arneb' 6-max Seat #1 is the button
Seat 1: cocololo91 (€6.24 in chips)
Seat 2: Luckers712 (€2.48 in chips)
Seat 3: Sánchez63 (€0.47 in chips)
Seat 4: Jou"Yonfa$" (€3.73 in chips)
Seat 5: leobcn9 (€2.86 in chips)
Seat 6: unounoporfavor (€9.73 in chips)
Luckers712: posts small blind €0.01
Sánchez63: posts big blind €0.02
*** HOLE CARDS ***
Dealt to Luckers712 [Kd Jd]
Jou"Yonfa$": folds
leobcn9: folds
unounoporfavor: raises €0.02 to €0.04
cocololo91: folds
Luckers712: calls €0.03
Sánchez63: calls €0.02
*** FLOP *** [4d 9h 4s]
Luckers712: checks
Sánchez63: checks
unounoporfavor: bets €0.04
Luckers712: calls €0.04
Sánchez63: folds
*** TURN *** [4d 9h 4s] [6d]
Luckers712: checks
unounoporfavor: bets €0.06
Luckers712: calls €0.06
*** RIVER *** [4d 9h 4s 6d] [As]
Luckers712: bets €0.46
unounoporfavor: folds
Uncalled bet (€0.46) returned to Luckers712
Luckers712 collected €0.30 from pot
Luckers712: doesn't show hand
*** SUMMARY ***
Total pot €0.32 | Rake €0.02
Board [4d 9h 4s 6d As]
Seat 1: cocololo91 (button) folded before Flop (didn't bet)
Seat 2: Luckers712 (small blind) collected (€0.30)
Seat 3: Sánchez63 (big blind) folded on the Flop
Seat 4: Jou"Yonfa$" folded before Flop (didn't bet)
Seat 5: leobcn9 folded before Flop (didn't bet)
Seat 6: unounoporfavor folded on the River



PokerStars Zoom Hand #210168973216:  Hold'em No Limit (€0.01/€0.02) - 2020/03/15 19:14:57 CET [2020/03/15 14:14:57 ET]
Table 'Arneb' 6-max Seat #1 is the button
Seat 1: ricmp (€12.91 in chips)
Seat 2: m.martines (€2.45 in chips)
Seat 3: sau1888 (€1.94 in chips)
Seat 4: Luckers712 (€2.64 in chips)
Seat 5: Miinervat (€2.51 in chips)
Seat 6: portospouto (€1.71 in chips)
m.martines: posts small blind €0.01
sau1888: posts big blind €0.02
*** HOLE CARDS ***
Dealt to Luckers712 [9d 7d]
Luckers712: raises €0.03 to €0.05
Miinervat: folds
portospouto: calls €0.05
ricmp: folds
m.martines: folds
sau1888: folds
*** FLOP *** [4h Qd 2h]
Luckers712: checks
portospouto: bets €0.06
Luckers712: calls €0.06
*** TURN *** [4h Qd 2h] [Kd]
Luckers712: bets €0.12
portospouto: calls €0.12
*** RIVER *** [4h Qd 2h Kd] [2s]
Luckers712: bets €0.36
portospouto: folds
Uncalled bet (€0.36) returned to Luckers712
Luckers712 collected €0.47 from pot
Luckers712: doesn't show hand
*** SUMMARY ***
Total pot €0.49 | Rake €0.02
Board [4h Qd 2h Kd 2s]
Seat 1: ricmp (button) folded before Flop (didn't bet)
Seat 2: m.martines (small blind) folded before Flop
Seat 3: sau1888 (big blind) folded before Flop
Seat 4: Luckers712 collected (€0.47)
Seat 5: Miinervat folded before Flop (didn't bet)
Seat 6: portospouto folded on the River



PokerStars Zoom Hand #210169037877:  Hold'em No Limit (€0.01/€0.02) - 2020/03/15 19:16:06 CET [2020/03/15 14:16:06 ET]
Table 'Arneb' 6-max Seat #1 is the button
Seat 1: ricmp (€12.88 in chips)
Seat 2: jmaigre (€1 in chips)
Seat 3: Luckers712 (€2.88 in chips)
Seat 4: BlueSeaPT (€2.35 in chips)
Seat 5: ekzemaker (€7.53 in chips)
Seat 6: KALASH71 (€1.66 in chips)
jmaigre: posts small blind €0.01
Luckers712: posts big blind €0.02
*** HOLE CARDS ***
Dealt to Luckers712 [4c 9d]
BlueSeaPT: folds
ekzemaker: folds
KALASH71: folds
ricmp: folds
jmaigre: calls €0.01
Luckers712: checks
*** FLOP *** [6d 4s Qs]
jmaigre: checks
Luckers712: bets €0.02
jmaigre: calls €0.02
*** TURN *** [6d 4s Qs] [Ah]
jmaigre: checks
Luckers712: checks
*** RIVER *** [6d 4s Qs Ah] [Qh]
jmaigre: checks
Luckers712: checks
*** SHOW DOWN ***
jmaigre: shows [5h 2c] (a pair of Queens)
Luckers712: shows [4c 9d] (two pair, Queens and Fours)
Luckers712 collected €0.08 from pot
*** SUMMARY ***
Total pot €0.08 | Rake €0
Board [6d 4s Qs Ah Qh]
Seat 1: ricmp (button) folded before Flop (didn't bet)
Seat 2: jmaigre (small blind) showed [5h 2c] and lost with a pair of Queens
Seat 3: Luckers712 (big blind) showed [4c 9d] and won (€0.08) with two pair, Queens and Fours
Seat 4: BlueSeaPT folded before Flop (didn't bet)
Seat 5: ekzemaker folded before Flop (didn't bet)
Seat 6: KALASH71 folded before Flop (didn't bet)



PokerStars Zoom Hand #210169069968:  Hold'em No Limit (€0.01/€0.02) - 2020/03/15 19:16:40 CET [2020/03/15 14:16:40 ET]
Table 'Arneb' 6-max Seat #1 is the button
Seat 1: Luckers712 (€2.92 in chips)
Seat 2: marcosibon (€1.86 in chips)
Seat 3: bilboubou78 (€3.83 in chips)
Seat 4: cecieetdavid (€2.75 in chips)
Seat 5: estevi_79 (€2.40 in chips)
Seat 6: ThePryce (€3.06 in chips)
marcosibon: posts small blind €0.01
bilboubou78: posts big blind €0.02
*** HOLE CARDS ***
Dealt to Luckers712 [Ac Js]
cecieetdavid: calls €0.02
estevi_79: folds
ThePryce: folds
Luckers712: raises €0.04 to €0.06
marcosibon: folds
bilboubou78: folds
cecieetdavid: calls €0.04
*** FLOP *** [5s Jc 8h]
cecieetdavid: checks
Luckers712: checks
*** TURN *** [5s Jc 8h] [9h]
cecieetdavid: checks
Luckers712: bets €0.09
cecieetdavid: calls €0.09
*** RIVER *** [5s Jc 8h 9h] [7s]
cecieetdavid: checks
Luckers712: bets €0.11
cecieetdavid: folds
Uncalled bet (€0.11) returned to Luckers712
Luckers712 collected €0.31 from pot
Luckers712: doesn't show hand
*** SUMMARY ***
Total pot €0.33 | Rake €0.02
Board [5s Jc 8h 9h 7s]
Seat 1: Luckers712 (button) collected (€0.31)
Seat 2: marcosibon (small blind) folded before Flop
Seat 3: bilboubou78 (big blind) folded before Flop
Seat 4: cecieetdavid folded on the River
Seat 5: estevi_79 folded before Flop (didn't bet)
Seat 6: ThePryce folded before Flop (didn't bet)



PokerStars Zoom Hand #210169139291:  Hold'em No Limit (€0.01/€0.02) - 2020/03/15 19:17:54 CET [2020/03/15 14:17:54 ET]
Table 'Arneb' 6-max Seat #1 is the button
Seat 1: reKKauudadoR (€2.39 in chips)
Seat 2: Luckers712 (€3.08 in chips)
Seat 3: Séneca Magic (€8.40 in chips)
Seat 4: cocololo91 (€6.19 in chips)
Seat 5: PatrickVence (€3.56 in chips)
Seat 6: TJDasNeves (€1.90 in chips)
Luckers712: posts small blind €0.01
Séneca Magic: posts big blind €0.02
*** HOLE CARDS ***
Dealt to Luckers712 [Kc 8s]
cocololo91: folds
PatrickVence: folds
TJDasNeves: folds
reKKauudadoR: folds
Luckers712: folds
Uncalled bet (€0.01) returned to Séneca Magic
Séneca Magic collected €0.02 from pot
Séneca Magic: doesn't show hand
*** SUMMARY ***
Total pot €0.02 | Rake €0
Seat 1: reKKauudadoR (button) folded before Flop (didn't bet)
Seat 2: Luckers712 (small blind) folded before Flop
Seat 3: Séneca Magic (big blind) collected (€0.02)
Seat 4: cocololo91 folded before Flop (didn't bet)
Seat 5: PatrickVence folded before Flop (didn't bet)
Seat 6: TJDasNeves folded before Flop (didn't bet)



PokerStars Zoom Hand #210169145802:  Hold'em No Limit (€0.01/€0.02) - 2020/03/15 19:18:01 CET [2020/03/15 14:18:01 ET]
Table 'Arneb' 6-max Seat #1 is the button
Seat 1: GorjeJacker (€2 in chips)
Seat 2: Alex2140Alex (€1.34 in chips)
Seat 3: Luckers712 (€3.07 in chips)
Seat 4: adrivicente (€2.93 in chips)
Seat 5: ThePryce (€1.74 in chips)
Seat 6: galodebarcelos (€4.67 in chips)
Alex2140Alex: posts small blind €0.01
Luckers712: posts big blind €0.02
*** HOLE CARDS ***
Dealt to Luckers712 [6s Jh]
adrivicente: folds
ThePryce: folds
galodebarcelos: folds
GorjeJacker: folds
Alex2140Alex: raises €0.02 to €0.04
Luckers712: folds
Uncalled bet (€0.02) returned to Alex2140Alex
Alex2140Alex collected €0.04 from pot
*** SUMMARY ***
Total pot €0.04 | Rake €0
Seat 1: GorjeJacker (button) folded before Flop (didn't bet)
Seat 2: Alex2140Alex (small blind) collected (€0.04)
Seat 3: Luckers712 (big blind) folded before Flop
Seat 4: adrivicente folded before Flop (didn't bet)
Seat 5: ThePryce folded before Flop (didn't bet)
Seat 6: galodebarcelos folded before Flop (didn't bet)



PokerStars Zoom Hand #210169162479:  Hold'em No Limit (€0.01/€0.02) - 2020/03/15 19:18:19 CET [2020/03/15 14:18:19 ET]
Table 'Arneb' 6-max Seat #1 is the button
Seat 1: bpbernardo (€3.28 in chips)
Seat 2: nick4tech (€5.83 in chips)
Seat 3: PITI1231 (€7.77 in chips)
Seat 4: Luckers712 (€3.05 in chips)
Seat 5: reKKauudadoR (€2.39 in chips)
Seat 6: raptureman1 (€2 in chips)
nick4tech: posts small blind €0.01
PITI1231: posts big blind €0.02
*** HOLE CARDS ***
Dealt to Luckers712 [7h 2c]
Luckers712: folds
reKKauudadoR: folds
raptureman1: folds
bpbernardo: folds
nick4tech: folds
Uncalled bet (€0.01) returned to PITI1231
PITI1231 collected €0.02 from pot
PITI1231: doesn't show hand
*** SUMMARY ***
Total pot €0.02 | Rake €0
Seat 1: bpbernardo (button) folded before Flop (didn't bet)
Seat 2: nick4tech (small blind) folded before Flop
Seat 3: PITI1231 (big blind) collected (€0.02)
Seat 4: Luckers712 folded before Flop (didn't bet)
Seat 5: reKKauudadoR folded before Flop (didn't bet)
Seat 6: raptureman1 folded before Flop (didn't bet)



PokerStars Zoom Hand #210169134498:  Hold'em No Limit (€0.01/€0.02) - 2020/03/15 19:17:49 CET [2020/03/15 14:17:49 ET]
Table 'Arneb' 6-max Seat #1 is the button
Seat 1: VenturaFCB (€2.03 in chips)
Seat 2: wilmar20 (€2.11 in chips)
Seat 3: kelloo01 (€14.54 in chips)
Seat 4: Repil (€1.77 in chips)
Seat 5: Luckers712 (€3.08 in chips)
Seat 6: 11.M.R.K.11 (€2.42 in chips)
wilmar20: posts small blind €0.01
kelloo01: posts big blind €0.02
*** HOLE CARDS ***
Dealt to Luckers712 [Ad 2h]
Repil: raises €0.04 to €0.06
Luckers712: folds
11.M.R.K.11: folds
VenturaFCB: folds
wilmar20: folds
kelloo01: calls €0.04
*** FLOP *** [6d Qd Jc]
kelloo01: checks
Repil: checks
*** TURN *** [6d Qd Jc] [Qh]
kelloo01: checks
Repil: bets €0.06
kelloo01: folds
Uncalled bet (€0.06) returned to Repil
Repil collected €0.12 from pot
Repil: doesn't show hand
*** SUMMARY ***
Total pot €0.13 | Rake €0.01
Board [6d Qd Jc Qh]
Seat 1: VenturaFCB (button) folded before Flop (didn't bet)
Seat 2: wilmar20 (small blind) folded before Flop
Seat 3: kelloo01 (big blind) folded on the Turn
Seat 4: Repil collected (€0.12)
Seat 5: Luckers712 folded before Flop (didn't bet)
Seat 6: 11.M.R.K.11 folded before Flop (didn't bet)



PokerStars Zoom Hand #210169158750:  Hold'em No Limit (€0.01/€0.02) - 2020/03/15 19:18:15 CET [2020/03/15 14:18:15 ET]
Table 'Arneb' 6-max Seat #1 is the button
Seat 1: cocololo91 (€6.17 in chips)
Seat 2: MDKristian (€2.82 in chips)
Seat 3: RuiBubu85 (€1.05 in chips)
Seat 4: Synestr0 (€3.88 in chips)
Seat 5: Delia7592 (€1.34 in chips)
Seat 6: Luckers712 (€3.05 in chips)
MDKristian: posts small blind €0.01
RuiBubu85: posts big blind €0.02
*** HOLE CARDS ***
Dealt to Luckers712 [7c 9d]
Synestr0: folds
Delia7592: raises €0.50 to €0.52
Luckers712: folds
cocololo91: folds
MDKristian: folds
RuiBubu85: raises €0.53 to €1.05 and is all-in
Delia7592: calls €0.53
*** FLOP *** [4d 8d 3s]
*** TURN *** [4d 8d 3s] [Ac]
*** RIVER *** [4d 8d 3s Ac] [8s]
*** SHOW DOWN ***
RuiBubu85: shows [Qh Qd] (two pair, Queens and Eights)
Delia7592: shows [7d 8h] (three of a kind, Eights)
Delia7592 collected €2 from pot
*** SUMMARY ***
Total pot €2.11 | Rake €0.11
Board [4d 8d 3s Ac 8s]
Seat 1: cocololo91 (button) folded before Flop (didn't bet)
Seat 2: MDKristian (small blind) folded before Flop
Seat 3: RuiBubu85 (big blind) showed [Qh Qd] and lost with two pair, Queens and Eights
Seat 4: Synestr0 folded before Flop (didn't bet)
Seat 5: Delia7592 showed [7d 8h] and won (€2) with three of a kind, Eights
Seat 6: Luckers712 folded before Flop (didn't bet)



PokerStars Zoom Hand #210169130810:  Hold'em No Limit (€0.01/€0.02) - 2020/03/15 19:17:45 CET [2020/03/15 14:17:45 ET]
Table 'Arneb' 6-max Seat #1 is the button
Seat 1: CrisR98 (€0.97 in chips)
Seat 2: mikolapiz1 (€2.13 in chips)
Seat 3: Robersaz (€7.07 in chips)
Seat 4: Luckers712 (€3.08 in chips)
Seat 5: Stoyan96 (€2.01 in chips)
Seat 6: martingete (€1.91 in chips)
mikolapiz1: posts small blind €0.01
Robersaz: posts big blind €0.02
*** HOLE CARDS ***
Dealt to Luckers712 [2d 6h]
Luckers712: folds
Stoyan96: raises €0.02 to €0.04
martingete: calls €0.04
CrisR98: calls €0.04
mikolapiz1: folds
Robersaz: raises €0.17 to €0.21
Stoyan96: calls €0.17
martingete: calls €0.17
CrisR98: calls €0.17
*** FLOP *** [Qc 3d Tc]
Robersaz: bets €0.40
Stoyan96: folds
martingete: calls €0.40
CrisR98: calls €0.40
*** TURN *** [Qc 3d Tc] [Qd]
Robersaz: checks
martingete: bets €1.30 and is all-in
CrisR98: calls €0.36 and is all-in
Robersaz: calls €1.30
*** RIVER *** [Qc 3d Tc Qd] [Kd]
*** SHOW DOWN ***
Robersaz: shows [Qh Qs] (four of a kind, Queens)
martingete: shows [Jd Ad] (a flush, Ace high)
Robersaz collected €1.79 from side pot
CrisR98: shows [4d 6d] (a flush, King high)
Robersaz collected €2.97 from main pot
*** SUMMARY ***
Total pot €5.01 Main pot €2.97. Side pot €1.79. | Rake €0.25
Board [Qc 3d Tc Qd Kd]
Seat 1: CrisR98 (button) showed [4d 6d] and lost with a flush, King high
Seat 2: mikolapiz1 (small blind) folded before Flop
Seat 3: Robersaz (big blind) showed [Qh Qs] and won (€4.76) with four of a kind, Queens
Seat 4: Luckers712 folded before Flop (didn't bet)
Seat 5: Stoyan96 folded on the Flop
Seat 6: martingete showed [Jd Ad] and lost with a flush, Ace high



PokerStars Zoom Hand #210169198255:  Hold'em No Limit (€0.01/€0.02) - 2020/03/15 19:18:58 CET [2020/03/15 14:18:58 ET]
Table 'Arneb' 6-max Seat #1 is the button
Seat 1: kyry68 (€1.72 in chips)
Seat 2: clapo44980 (€1.06 in chips)
Seat 3: ToniMarteens (€3.25 in chips)
Seat 4: Luckers712 (€3.02 in chips)
Seat 5: tetar1000d (€3.03 in chips)
Seat 6: BlueSeaPT (€1.90 in chips)
clapo44980: posts small blind €0.01
ToniMarteens: posts big blind €0.02
*** HOLE CARDS ***
Dealt to Luckers712 [2d 6c]
Luckers712: folds
tetar1000d: folds
BlueSeaPT: folds
kyry68: folds
clapo44980: folds
Uncalled bet (€0.01) returned to ToniMarteens
ToniMarteens collected €0.02 from pot
ToniMarteens: doesn't show hand
*** SUMMARY ***
Total pot €0.02 | Rake €0
Seat 1: kyry68 (button) folded before Flop (didn't bet)
Seat 2: clapo44980 (small blind) folded before Flop
Seat 3: ToniMarteens (big blind) collected (€0.02)
Seat 4: Luckers712 folded before Flop (didn't bet)
Seat 5: tetar1000d folded before Flop (didn't bet)
Seat 6: BlueSeaPT folded before Flop (didn't bet)



PokerStars Zoom Hand #210169167236:  Hold'em No Limit (€0.01/€0.02) - 2020/03/15 19:18:24 CET [2020/03/15 14:18:24 ET]
Table 'Arneb' 6-max Seat #1 is the button
Seat 1: Luckers712 (€3.05 in chips)
Seat 2: ricmp (€4.63 in chips)
Seat 3: aureaStar (€2 in chips)
Seat 4: lusto09 (€2 in chips)
Seat 5: chiwas12 (€2.11 in chips)
Seat 6: lucky13re (€2 in chips)
ricmp: posts small blind €0.01
aureaStar: posts big blind €0.02
*** HOLE CARDS ***
Dealt to Luckers712 [8c Qh]
lusto09: folds
chiwas12: raises €0.04 to €0.06
lucky13re: folds
Luckers712: folds
ricmp: folds
aureaStar: raises €0.06 to €0.12
chiwas12: calls €0.06
*** FLOP *** [2h Jd 8d]
aureaStar: bets €0.06
chiwas12: calls €0.06
*** TURN *** [2h Jd 8d] [2s]
aureaStar: bets €0.18
chiwas12: calls €0.18
*** RIVER *** [2h Jd 8d 2s] [8h]
aureaStar: checks
chiwas12: checks
*** SHOW DOWN ***
aureaStar: shows [As Ah] (two pair, Aces and Eights)
chiwas12: mucks hand
aureaStar collected €0.69 from pot
*** SUMMARY ***
Total pot €0.73 | Rake €0.04
Board [2h Jd 8d 2s 8h]
Seat 1: Luckers712 (button) folded before Flop (didn't bet)
Seat 2: ricmp (small blind) folded before Flop
Seat 3: aureaStar (big blind) showed [As Ah] and won (€0.69) with two pair, Aces and Eights
Seat 4: lusto09 folded before Flop (didn't bet)
Seat 5: chiwas12 mucked [6h 6s]
Seat 6: lucky13re folded before Flop (didn't bet)



PokerStars Zoom Hand #210169171958:  Hold'em No Limit (€0.01/€0.02) - 2020/03/15 19:18:29 CET [2020/03/15 14:18:29 ET]
Table 'Arneb' 6-max Seat #1 is the button
Seat 1: dropthebill (€1.10 in chips)
Seat 2: empiresports (€1.58 in chips)
Seat 3: Capitan Aab (€2.14 in chips)
Seat 4: Torcador (€1.39 in chips)
Seat 5: dipibo7 (€4.51 in chips)
Seat 6: Luckers712 (€3.05 in chips)
empiresports: posts small blind €0.01
Capitan Aab: posts big blind €0.02
*** HOLE CARDS ***
Dealt to Luckers712 [5s Ks]
Torcador: folds
dipibo7: raises €0.03 to €0.05
Luckers712: folds
dropthebill: folds
empiresports: raises €0.12 to €0.17
Capitan Aab: folds
dipibo7: raises €0.12 to €0.29
empiresports: raises €1.29 to €1.58 and is all-in
dipibo7: calls €1.29
*** FLOP *** [4d 2c Th]
*** TURN *** [4d 2c Th] [4s]
*** RIVER *** [4d 2c Th 4s] [3d]
*** SHOW DOWN ***
empiresports: shows [4c 4h] (four of a kind, Fours)
dipibo7: shows [As Qc] (a pair of Fours)
empiresports collected €3.02 from pot
*** SUMMARY ***
Total pot €3.18 | Rake €0.16
Board [4d 2c Th 4s 3d]
Seat 1: dropthebill (button) folded before Flop (didn't bet)
Seat 2: empiresports (small blind) showed [4c 4h] and won (€3.02) with four of a kind, Fours
Seat 3: Capitan Aab (big blind) folded before Flop
Seat 4: Torcador folded before Flop (didn't bet)
Seat 5: dipibo7 showed [As Qc] and lost with a pair of Fours
Seat 6: Luckers712 folded before Flop (didn't bet)



PokerStars Zoom Hand #210169189687:  Hold'em No Limit (€0.01/€0.02) - 2020/03/15 19:18:48 CET [2020/03/15 14:18:48 ET]
Table 'Arneb' 6-max Seat #1 is the button
Seat 1: adrivicente (€2.99 in chips)
Seat 2: Luckers712 (€3.03 in chips)
Seat 3: ricmp (€4.62 in chips)
Seat 4: recis (€1.38 in chips)
Seat 5: MMalú3 (€1.52 in chips)
Seat 6: alvaroo8 (€1.54 in chips)
Luckers712: posts small blind €0.01
ricmp: posts big blind €0.02
*** HOLE CARDS ***
Dealt to Luckers712 [9c 8s]
recis: folds
MMalú3: raises €0.02 to €0.04
alvaroo8: folds
adrivicente: folds
Luckers712: folds
ricmp: folds
Uncalled bet (€0.02) returned to MMalú3
MMalú3 collected €0.05 from pot
MMalú3: doesn't show hand
*** SUMMARY ***
Total pot €0.05 | Rake €0
Seat 1: adrivicente (button) folded before Flop (didn't bet)
Seat 2: Luckers712 (small blind) folded before Flop
Seat 3: ricmp (big blind) folded before Flop
Seat 4: recis folded before Flop (didn't bet)
Seat 5: MMalú3 collected (€0.05)
Seat 6: alvaroo8 folded before Flop (didn't bet)



PokerStars Zoom Hand #210169209893:  Hold'em No Limit (€0.01/€0.02) - 2020/03/15 19:19:12 CET [2020/03/15 14:19:12 ET]
Table 'Arneb' 6-max Seat #1 is the button
Seat 1: MDKristian (€2.78 in chips)
Seat 2: Kayfidze (€2.59 in chips)
Seat 3: al118360 (€1.71 in chips)
Seat 4: pinuccio177 (€1.48 in chips)
Seat 5: Luckers712 (€3.02 in chips)
Seat 6: SaiyanSergio (€2 in chips)
Kayfidze: posts small blind €0.01
al118360: posts big blind €0.02
*** HOLE CARDS ***
Dealt to Luckers712 [3h 6d]
pinuccio177: raises €0.04 to €0.06
Luckers712: folds
SaiyanSergio: folds
MDKristian: folds
Kayfidze: folds
al118360: folds
Uncalled bet (€0.04) returned to pinuccio177
pinuccio177 collected €0.05 from pot
pinuccio177: doesn't show hand
*** SUMMARY ***
Total pot €0.05 | Rake €0
Seat 1: MDKristian (button) folded before Flop (didn't bet)
Seat 2: Kayfidze (small blind) folded before Flop
Seat 3: al118360 (big blind) folded before Flop
Seat 4: pinuccio177 collected (€0.05)
Seat 5: Luckers712 folded before Flop (didn't bet)
Seat 6: SaiyanSergio folded before Flop (didn't bet)



PokerStars Zoom Hand #210169175735:  Hold'em No Limit (€0.01/€0.02) - 2020/03/15 19:18:33 CET [2020/03/15 14:18:33 ET]
Table 'Arneb' 6-max Seat #1 is the button
Seat 1: cad1959 (€2.04 in chips)
Seat 2: kelloo01 (€14.48 in chips)
Seat 3: Luckers712 (€3.05 in chips)
Seat 4: Chunclis (€1.07 in chips)
Seat 5: bilbaostars (€1.64 in chips)
Seat 6: TJDasNeves (€2.04 in chips)
kelloo01: posts small blind €0.01
Luckers712: posts big blind €0.02
*** HOLE CARDS ***
Dealt to Luckers712 [2h Qc]
Chunclis: folds
bilbaostars: raises €0.02 to €0.04
TJDasNeves: folds
cad1959: calls €0.04
kelloo01: folds
Luckers712: folds
*** FLOP *** [5s Ac 5d]
bilbaostars: bets €0.04
cad1959: calls €0.04
*** TURN *** [5s Ac 5d] [Jc]
bilbaostars: bets €0.04
cad1959: folds
Uncalled bet (€0.04) returned to bilbaostars
bilbaostars collected €0.18 from pot
bilbaostars: doesn't show hand
*** SUMMARY ***
Total pot €0.19 | Rake €0.01
Board [5s Ac 5d Jc]
Seat 1: cad1959 (button) folded on the Turn
Seat 2: kelloo01 (small blind) folded before Flop
Seat 3: Luckers712 (big blind) folded before Flop
Seat 4: Chunclis folded before Flop (didn't bet)
Seat 5: bilbaostars collected (€0.18)
Seat 6: TJDasNeves folded before Flop (didn't bet)



PokerStars Zoom Hand #210169194873:  Hold'em No Limit (€0.01/€0.02) - 2020/03/15 19:18:54 CET [2020/03/15 14:18:54 ET]
Table 'Arneb' 6-max Seat #1 is the button
Seat 1: punisher1106 (€1.99 in chips)
Seat 2: obremo32 (€2.14 in chips)
Seat 3: bilboubou78 (€2.92 in chips)
Seat 4: ToniMarteens (€3.25 in chips)
Seat 5: Luckers712 (€3.02 in chips)
Seat 6: LCParreira86 (€2.30 in chips)
obremo32: posts small blind €0.01
bilboubou78: posts big blind €0.02
*** HOLE CARDS ***
Dealt to Luckers712 [Qc 3d]
ToniMarteens: folds
Luckers712: folds
LCParreira86: folds
punisher1106: raises €0.08 to €0.10
obremo32: folds
bilboubou78: calls €0.08
*** FLOP *** [4h Ad Ts]
bilboubou78: checks
punisher1106: checks
*** TURN *** [4h Ad Ts] [9s]
bilboubou78: bets €0.10
punisher1106: folds
Uncalled bet (€0.10) returned to bilboubou78
bilboubou78 collected €0.20 from pot
bilboubou78: doesn't show hand
*** SUMMARY ***
Total pot €0.21 | Rake €0.01
Board [4h Ad Ts 9s]
Seat 1: punisher1106 (button) folded on the Turn
Seat 2: obremo32 (small blind) folded before Flop
Seat 3: bilboubou78 (big blind) collected (€0.20)
Seat 4: ToniMarteens folded before Flop (didn't bet)
Seat 5: Luckers712 folded before Flop (didn't bet)
Seat 6: LCParreira86 folded before Flop (didn't bet)



PokerStars Zoom Hand #210169213308:  Hold'em No Limit (€0.01/€0.02) - 2020/03/15 19:19:16 CET [2020/03/15 14:19:16 ET]
Table 'Arneb' 6-max Seat #1 is the button
Seat 1: masquisiera (€2.18 in chips)
Seat 2: Luckers712 (€3.02 in chips)
Seat 3: Aria71321 (€0.90 in chips)
Seat 4: R1p-j (€4.98 in chips)
Seat 5: nick4tech (€5.68 in chips)
Seat 6: Kayfidze (€2.63 in chips)
Luckers712: posts small blind €0.01
Aria71321: posts big blind €0.02
*** HOLE CARDS ***
Dealt to Luckers712 [Ad Ks]
R1p-j has timed out
R1p-j: folds
nick4tech: folds
Kayfidze: folds
masquisiera: folds
Luckers712: raises €0.03 to €0.05
Aria71321: folds
Uncalled bet (€0.03) returned to Luckers712
Luckers712 collected €0.04 from pot
Luckers712: doesn't show hand
*** SUMMARY ***
Total pot €0.04 | Rake €0
Seat 1: masquisiera (button) folded before Flop (didn't bet)
Seat 2: Luckers712 (small blind) collected (€0.04)
Seat 3: Aria71321 (big blind) folded before Flop
Seat 4: R1p-j folded before Flop (didn't bet)
Seat 5: nick4tech folded before Flop (didn't bet)
Seat 6: Kayfidze folded before Flop (didn't bet)



PokerStars Zoom Hand #210169237856:  Hold'em No Limit (€0.01/€0.02) - 2020/03/15 19:19:43 CET [2020/03/15 14:19:43 ET]
Table 'Arneb' 6-max Seat #1 is the button
Seat 1: tricerbero (€1.97 in chips)
Seat 2: Franç@ (€6.86 in chips)
Seat 3: Luckers712 (€3.04 in chips)
Seat 4: Chunclis (€1.86 in chips)
Seat 5: Cangrejocotyx (€0.84 in chips)
Seat 6: Púlsar (€2.85 in chips)
Franç@: posts small blind €0.01
Luckers712: posts big blind €0.02
*** HOLE CARDS ***
Dealt to Luckers712 [6d Qh]
Chunclis: folds
Cangrejocotyx: folds
Púlsar: raises €0.04 to €0.06
tricerbero: folds
Franç@: calls €0.05
Luckers712: folds
*** FLOP *** [Jc 8c 7c]
Franç@: bets €0.06
Púlsar: folds
Uncalled bet (€0.06) returned to Franç@
Franç@ collected €0.13 from pot
Franç@: doesn't show hand
*** SUMMARY ***
Total pot €0.14 | Rake €0.01
Board [Jc 8c 7c]
Seat 1: tricerbero (button) folded before Flop (didn't bet)
Seat 2: Franç@ (small blind) collected (€0.13)
Seat 3: Luckers712 (big blind) folded before Flop
Seat 4: Chunclis folded before Flop (didn't bet)
Seat 5: Cangrejocotyx folded before Flop (didn't bet)
Seat 6: Púlsar folded on the Flop



PokerStars Zoom Hand #210169202385:  Hold'em No Limit (€0.01/€0.02) - 2020/03/15 19:19:03 CET [2020/03/15 14:19:03 ET]
Table 'Arneb' 6-max Seat #1 is the button
Seat 1: Luckers712 (€3.02 in chips)
Seat 2: TJDasNeves (€1.93 in chips)
Seat 3: BlueSeaPT (€1.90 in chips)
Seat 4: roms421984 (€0.61 in chips)
Seat 5: Dark_make632 (€2.76 in chips)
Seat 6: petitgold (€2.14 in chips)
TJDasNeves: posts small blind €0.01
BlueSeaPT: posts big blind €0.02
*** HOLE CARDS ***
Dealt to Luckers712 [As 2c]
roms421984: calls €0.02
Dark_make632: raises €0.08 to €0.10
petitgold: folds
Luckers712: folds
TJDasNeves: folds
BlueSeaPT: folds
roms421984: calls €0.08
*** FLOP *** [5d 4d 3c]
roms421984: checks
Dark_make632: checks
*** TURN *** [5d 4d 3c] [Ad]
roms421984: checks
Dark_make632: checks
*** RIVER *** [5d 4d 3c Ad] [Ks]
roms421984: checks
Dark_make632: bets €0.07
roms421984: folds
Uncalled bet (€0.07) returned to Dark_make632
Dark_make632 collected €0.22 from pot
Dark_make632: doesn't show hand
*** SUMMARY ***
Total pot €0.23 | Rake €0.01
Board [5d 4d 3c Ad Ks]
Seat 1: Luckers712 (button) folded before Flop (didn't bet)
Seat 2: TJDasNeves (small blind) folded before Flop
Seat 3: BlueSeaPT (big blind) folded before Flop
Seat 4: roms421984 folded on the River
Seat 5: Dark_make632 collected (€0.22)
Seat 6: petitgold folded before Flop (didn't bet)



PokerStars Zoom Hand #210169246380:  Hold'em No Limit (€0.01/€0.02) - 2020/03/15 19:19:52 CET [2020/03/15 14:19:52 ET]
Table 'Arneb' 6-max Seat #1 is the button
Seat 1: RuiBubu85 (€1.09 in chips)
Seat 2: Shzen8 (€2.01 in chips)
Seat 3: clapo44980 (€1.05 in chips)
Seat 4: Luckers712 (€3.02 in chips)
Seat 5: chris8200178 (€3.44 in chips)
Seat 6: manusilva401 (€5.57 in chips)
Shzen8: posts small blind €0.01
clapo44980: posts big blind €0.02
*** HOLE CARDS ***
Dealt to Luckers712 [Th Ks]
Luckers712: folds
chris8200178: calls €0.02
manusilva401: folds
RuiBubu85: folds
Shzen8: folds
clapo44980: checks
*** FLOP *** [4d 5c Js]
clapo44980: checks
chris8200178: bets €0.04
clapo44980: folds
Uncalled bet (€0.04) returned to chris8200178
chris8200178 collected €0.05 from pot
chris8200178: doesn't show hand
*** SUMMARY ***
Total pot €0.05 | Rake €0
Board [4d 5c Js]
Seat 1: RuiBubu85 (button) folded before Flop (didn't bet)
Seat 2: Shzen8 (small blind) folded before Flop
Seat 3: clapo44980 (big blind) folded on the Flop
Seat 4: Luckers712 folded before Flop (didn't bet)
Seat 5: chris8200178 collected (€0.05)
Seat 6: manusilva401 folded before Flop (didn't bet)



PokerStars Zoom Hand #210169251388:  Hold'em No Limit (€0.01/€0.02) - 2020/03/15 19:19:57 CET [2020/03/15 14:19:57 ET]
Table 'Arneb' 6-max Seat #1 is the button
Seat 1: Aria71321 (€0.88 in chips)
Seat 2: Vitorhcsousa (€2.04 in chips)
Seat 3: israel476 (€2.91 in chips)
Seat 4: ChaCha120488 (€0.40 in chips)
Seat 5: Kayfidze (€2.56 in chips)
Seat 6: Luckers712 (€3.02 in chips)
Vitorhcsousa: posts small blind €0.01
israel476: posts big blind €0.02
*** HOLE CARDS ***
Dealt to Luckers712 [Kh 6s]
ChaCha120488: folds
Kayfidze: folds
Luckers712: folds
Aria71321: raises €0.03 to €0.05
Vitorhcsousa: folds
israel476: folds
Uncalled bet (€0.03) returned to Aria71321
Aria71321 collected €0.05 from pot
Aria71321: doesn't show hand
*** SUMMARY ***
Total pot €0.05 | Rake €0
Seat 1: Aria71321 (button) collected (€0.05)
Seat 2: Vitorhcsousa (small blind) folded before Flop
Seat 3: israel476 (big blind) folded before Flop
Seat 4: ChaCha120488 folded before Flop (didn't bet)
Seat 5: Kayfidze folded before Flop (didn't bet)
Seat 6: Luckers712 folded before Flop (didn't bet)



PokerStars Zoom Hand #210169256180:  Hold'em No Limit (€0.01/€0.02) - 2020/03/15 19:20:02 CET [2020/03/15 14:20:02 ET]
Table 'Arneb' 6-max Seat #1 is the button
Seat 1: Mad Sputnik (€1.70 in chips)
Seat 2: GorjeJacker (€2.31 in chips)
Seat 3: Veesile (€2.12 in chips)
Seat 4: Luckers712 (€3.02 in chips)
Seat 5: Shzen8 (€1.94 in chips)
Seat 6: jokerchess10 (€2.23 in chips)
GorjeJacker: posts small blind €0.01
Veesile: posts big blind €0.02
*** HOLE CARDS ***
Dealt to Luckers712 [Th 8d]
Luckers712: folds
Shzen8: folds
jokerchess10: raises €0.02 to €0.04
Mad Sputnik: folds
GorjeJacker: raises €0.14 to €0.18
Veesile: folds
jokerchess10: calls €0.14
*** FLOP *** [5h Ac Kd]
GorjeJacker: checks
jokerchess10: checks
*** TURN *** [5h Ac Kd] [9s]
GorjeJacker: checks
jokerchess10: checks
*** RIVER *** [5h Ac Kd 9s] [As]
GorjeJacker: bets €0.27
jokerchess10: calls €0.27
*** SHOW DOWN ***
GorjeJacker: shows [Kc Qh] (two pair, Aces and Kings)
jokerchess10: mucks hand
GorjeJacker collected €0.87 from pot
*** SUMMARY ***
Total pot €0.92 | Rake €0.05
Board [5h Ac Kd 9s As]
Seat 1: Mad Sputnik (button) folded before Flop (didn't bet)
Seat 2: GorjeJacker (small blind) showed [Kc Qh] and won (€0.87) with two pair, Aces and Kings
Seat 3: Veesile (big blind) folded before Flop
Seat 4: Luckers712 folded before Flop (didn't bet)
Seat 5: Shzen8 folded before Flop (didn't bet)
Seat 6: jokerchess10 mucked [Js Kh]



PokerStars Zoom Hand #210169259922:  Hold'em No Limit (€0.01/€0.02) - 2020/03/15 19:20:06 CET [2020/03/15 14:20:06 ET]
Table 'Arneb' 6-max Seat #1 is the button
Seat 1: KALASH71 (€1.48 in chips)
Seat 2: Luckers712 (€3.02 in chips)
Seat 3: DNooXLvv (€6.09 in chips)
Seat 4: chiwas12 (€4.98 in chips)
Seat 5: patriacs (€5.40 in chips)
Seat 6: Synestr0 (€4.05 in chips)
Luckers712: posts small blind €0.01
DNooXLvv: posts big blind €0.02
*** HOLE CARDS ***
Dealt to Luckers712 [Td Ad]
chiwas12: folds
patriacs: raises €0.04 to €0.06
Synestr0: folds
KALASH71: folds
Luckers712: calls €0.05
DNooXLvv: folds
*** FLOP *** [6d 2h Jc]
Luckers712: checks
patriacs: bets €0.06
Luckers712: calls €0.06
*** TURN *** [6d 2h Jc] [Kd]
Luckers712: checks
patriacs: bets €0.14
Luckers712: calls €0.14
*** RIVER *** [6d 2h Jc Kd] [Qs]
Luckers712: bets €1.10
patriacs: calls €1.10
*** SHOW DOWN ***
Luckers712: shows [Td Ad] (a straight, Ten to Ace)
patriacs: mucks hand
Luckers712 collected €2.60 from pot
*** SUMMARY ***
Total pot €2.74 | Rake €0.14
Board [6d 2h Jc Kd Qs]
Seat 1: KALASH71 (button) folded before Flop (didn't bet)
Seat 2: Luckers712 (small blind) showed [Td Ad] and won (€2.60) with a straight, Ten to Ace
Seat 3: DNooXLvv (big blind) folded before Flop
Seat 4: chiwas12 folded before Flop (didn't bet)
Seat 5: patriacs mucked [Ks Jh]
Seat 6: Synestr0 folded before Flop (didn't bet)



PokerStars Zoom Hand #210169415109:  Hold'em No Limit (€0.01/€0.02) - 2020/03/15 19:22:49 CET [2020/03/15 14:22:49 ET]
Table 'Arneb' 6-max Seat #1 is the button
Seat 1: Luckers712 (€4.26 in chips)
Seat 2: ricmp (€12.70 in chips)
Seat 3: Torcador (€1.23 in chips)
Seat 4: jacksparr485 (€2.35 in chips)
Seat 5: Carma312 (€1.35 in chips)
Seat 6: aureaStar (€1.86 in chips)
ricmp: posts small blind €0.01
Torcador: posts big blind €0.02
*** HOLE CARDS ***
Dealt to Luckers712 [6s Kc]
jacksparr485: folds
Carma312: folds
aureaStar: folds
Luckers712: folds
ricmp: folds
Uncalled bet (€0.01) returned to Torcador
Torcador collected €0.02 from pot
Torcador: doesn't show hand
*** SUMMARY ***
Total pot €0.02 | Rake €0
Seat 1: Luckers712 (button) folded before Flop (didn't bet)
Seat 2: ricmp (small blind) folded before Flop
Seat 3: Torcador (big blind) collected (€0.02)
Seat 4: jacksparr485 folded before Flop (didn't bet)
Seat 5: Carma312 folded before Flop (didn't bet)
Seat 6: aureaStar folded before Flop (didn't bet)



PokerStars Zoom Hand #210169431300:  Hold'em No Limit (€0.01/€0.02) - 2020/03/15 19:23:06 CET [2020/03/15 14:23:06 ET]
Table 'Arneb' 6-max Seat #1 is the button
Seat 1: lusto09 (€2.80 in chips)
Seat 2: bilboubou78 (€4.61 in chips)
Seat 3: Luckers712 (€4.26 in chips)
Seat 4: freececi (€3.66 in chips)
Seat 5: Seron1023 (€2.43 in chips)
Seat 6: pandemon (€6.23 in chips)
bilboubou78: posts small blind €0.01
Luckers712: posts big blind €0.02
*** HOLE CARDS ***
Dealt to Luckers712 [7s Ks]
freececi: folds
Seron1023: folds
pandemon: folds
lusto09: raises €0.04 to €0.06
bilboubou78: folds
Luckers712: calls €0.04
*** FLOP *** [Jd Qd 3c]
Luckers712: checks
lusto09: checks
*** TURN *** [Jd Qd 3c] [4c]
Luckers712: checks
lusto09: bets €0.04
Luckers712: folds
Uncalled bet (€0.04) returned to lusto09
lusto09 collected €0.12 from pot
*** SUMMARY ***
Total pot €0.13 | Rake €0.01
Board [Jd Qd 3c 4c]
Seat 1: lusto09 (button) collected (€0.12)
Seat 2: bilboubou78 (small blind) folded before Flop
Seat 3: Luckers712 (big blind) folded on the Turn
Seat 4: freececi folded before Flop (didn't bet)
Seat 5: Seron1023 folded before Flop (didn't bet)
Seat 6: pandemon folded before Flop (didn't bet)



PokerStars Zoom Hand #210169476037:  Hold'em No Limit (€0.01/€0.02) - 2020/03/15 19:23:44 CET [2020/03/15 14:23:44 ET]
Table 'Arneb' 6-max Seat #1 is the button
Seat 1: reKKauudadoR (€2.69 in chips)
Seat 2: Veesile (€3.76 in chips)
Seat 3: ivan_ojuelo (€2.17 in chips)
Seat 4: raptureman1 (€2.84 in chips)
Seat 5: Markitos PT (€2.29 in chips)
Seat 6: Luckers712 (€4.20 in chips)
Veesile: posts small blind €0.01
ivan_ojuelo: posts big blind €0.02
*** HOLE CARDS ***
Dealt to Luckers712 [6s Th]
raptureman1: folds
Markitos PT: folds
Luckers712: folds
reKKauudadoR: folds
Veesile: folds
Uncalled bet (€0.01) returned to ivan_ojuelo
ivan_ojuelo collected €0.02 from pot
ivan_ojuelo: doesn't show hand
*** SUMMARY ***
Total pot €0.02 | Rake €0
Seat 1: reKKauudadoR (button) folded before Flop (didn't bet)
Seat 2: Veesile (small blind) folded before Flop
Seat 3: ivan_ojuelo (big blind) collected (€0.02)
Seat 4: raptureman1 folded before Flop (didn't bet)
Seat 5: Markitos PT folded before Flop (didn't bet)
Seat 6: Luckers712 folded before Flop (didn't bet)



PokerStars Zoom Hand #210169479700:  Hold'em No Limit (€0.01/€0.02) - 2020/03/15 19:23:48 CET [2020/03/15 14:23:48 ET]
Table 'Arneb' 6-max Seat #1 is the button
Seat 1: Dark_make632 (€2.20 in chips)
Seat 2: VenturaFCB (€1.86 in chips)
Seat 3: FishingBull75 (€2.12 in chips)
Seat 4: pcea74 (€2 in chips)
Seat 5: Luckers712 (€4.20 in chips)
Seat 6: smichet (€1.75 in chips)
VenturaFCB: posts small blind €0.01
FishingBull75: posts big blind €0.02
*** HOLE CARDS ***
Dealt to Luckers712 [Kc Qd]
pcea74: folds
Luckers712: raises €0.03 to €0.05
smichet: calls €0.05
Dark_make632: folds
VenturaFCB: folds
FishingBull75: calls €0.03
*** FLOP *** [6d 3c Jc]
FishingBull75: checks
Luckers712: checks
smichet: checks
*** TURN *** [6d 3c Jc] [3d]
FishingBull75: bets €0.10
Luckers712: folds
smichet: folds
Uncalled bet (€0.10) returned to FishingBull75
FishingBull75 collected €0.15 from pot
FishingBull75: doesn't show hand
*** SUMMARY ***
Total pot €0.16 | Rake €0.01
Board [6d 3c Jc 3d]
Seat 1: Dark_make632 (button) folded before Flop (didn't bet)
Seat 2: VenturaFCB (small blind) folded before Flop
Seat 3: FishingBull75 (big blind) collected (€0.15)
Seat 4: pcea74 folded before Flop (didn't bet)
Seat 5: Luckers712 folded on the Turn
Seat 6: smichet folded on the Turn



PokerStars Zoom Hand #210169521900:  Hold'em No Limit (€0.01/€0.02) - 2020/03/15 19:24:33 CET [2020/03/15 14:24:33 ET]
Table 'Arneb' 6-max Seat #1 is the button
Seat 1: FishingBull75 (€2.22 in chips)
Seat 2: Luckers712 (€4.15 in chips)
Seat 3: Ispea (€0.82 in chips)
Seat 4: j om13015 (€1 in chips)
Seat 5: Ballagarey (€2.17 in chips)
Seat 6: tulcio (€2.04 in chips)
Luckers712: posts small blind €0.01
Ispea: posts big blind €0.02
*** HOLE CARDS ***
Dealt to Luckers712 [Ah 9c]
j om13015: folds
Ballagarey: raises €0.04 to €0.06
tulcio: folds
FishingBull75: folds
Luckers712: calls €0.05
Ispea: folds
*** FLOP *** [Ad 4s 3c]
Luckers712: checks
Ballagarey: bets €0.07
Luckers712: calls €0.07
*** TURN *** [Ad 4s 3c] [Js]
Luckers712: checks
Ballagarey: checks
*** RIVER *** [Ad 4s 3c Js] [5c]
Luckers712: checks
Ballagarey: checks
*** SHOW DOWN ***
Luckers712: shows [Ah 9c] (a pair of Aces)
Ballagarey: mucks hand
Luckers712 collected €0.27 from pot
*** SUMMARY ***
Total pot €0.28 | Rake €0.01
Board [Ad 4s 3c Js 5c]
Seat 1: FishingBull75 (button) folded before Flop (didn't bet)
Seat 2: Luckers712 (small blind) showed [Ah 9c] and won (€0.27) with a pair of Aces
Seat 3: Ispea (big blind) folded before Flop
Seat 4: j om13015 folded before Flop (didn't bet)
Seat 5: Ballagarey mucked [Qd Qc]
Seat 6: tulcio folded before Flop (didn't bet)



PokerStars Zoom Hand #210169586969:  Hold'em No Limit (€0.01/€0.02) - 2020/03/15 19:25:42 CET [2020/03/15 14:25:42 ET]
Table 'Arneb' 6-max Seat #1 is the button
Seat 1: Luckers712 (€4.29 in chips)
Seat 2: NanoLMP (€5.84 in chips)
Seat 3: Sespir (€4.24 in chips)
Seat 4: j.cerqueira (€2.15 in chips)
Seat 5: PITI1231 (€2 in chips)
Seat 6: E74raiz (€2 in chips)
NanoLMP: posts small blind €0.01
Sespir: posts big blind €0.02
*** HOLE CARDS ***
Dealt to Luckers712 [Qs 8s]
j.cerqueira: folds
PITI1231: raises €0.04 to €0.06
E74raiz: folds
Luckers712: calls €0.06
NanoLMP: folds
Sespir: folds
*** FLOP *** [2d 6d 6c]
PITI1231: checks
Luckers712: checks
*** TURN *** [2d 6d 6c] [Kd]
PITI1231: bets €0.04
Luckers712: folds
Uncalled bet (€0.04) returned to PITI1231
PITI1231 collected €0.14 from pot
PITI1231: doesn't show hand
*** SUMMARY ***
Total pot €0.15 | Rake €0.01
Board [2d 6d 6c Kd]
Seat 1: Luckers712 (button) folded on the Turn
Seat 2: NanoLMP (small blind) folded before Flop
Seat 3: Sespir (big blind) folded before Flop
Seat 4: j.cerqueira folded before Flop (didn't bet)
Seat 5: PITI1231 collected (€0.14)
Seat 6: E74raiz folded before Flop (didn't bet)



PokerStars Zoom Hand #210169639335:  Hold'em No Limit (€0.01/€0.02) - 2020/03/15 19:26:38 CET [2020/03/15 14:26:38 ET]
Table 'Arneb' 6-max Seat #1 is the button
Seat 1: manuelsg89 (€2.04 in chips)
Seat 2: aishadavid (€0.34 in chips)
Seat 3: Luckers712 (€4.23 in chips)
Seat 4: trasar13 (€4.68 in chips)
Seat 5: SaiyanSergio (€2.61 in chips)
Seat 6: unounoporfavor (€5.49 in chips)
aishadavid: posts small blind €0.01
Luckers712: posts big blind €0.02
*** HOLE CARDS ***
Dealt to Luckers712 [8s Qc]
trasar13: folds
SaiyanSergio: folds
unounoporfavor: raises €0.02 to €0.04
manuelsg89: folds
aishadavid: calls €0.03
Luckers712: calls €0.02
*** FLOP *** [8d 3h 5c]
aishadavid: checks
Luckers712: bets €0.06
unounoporfavor: calls €0.06
aishadavid: calls €0.06
*** TURN *** [8d 3h 5c] [As]
aishadavid: checks
Luckers712: checks
unounoporfavor: bets €0.08
aishadavid: folds
Luckers712: calls €0.08
*** RIVER *** [8d 3h 5c As] [4c]
Luckers712: checks
unounoporfavor: checks
*** SHOW DOWN ***
Luckers712: shows [8s Qc] (a pair of Eights)
unounoporfavor: shows [8c Qd] (a pair of Eights)
Luckers712 collected €0.22 from pot
unounoporfavor collected €0.22 from pot
*** SUMMARY ***
Total pot €0.46 | Rake €0.02
Board [8d 3h 5c As 4c]
Seat 1: manuelsg89 (button) folded before Flop (didn't bet)
Seat 2: aishadavid (small blind) folded on the Turn
Seat 3: Luckers712 (big blind) showed [8s Qc] and won (€0.22) with a pair of Eights
Seat 4: trasar13 folded before Flop (didn't bet)
Seat 5: SaiyanSergio folded before Flop (didn't bet)
Seat 6: unounoporfavor showed [8c Qd] and won (€0.22) with a pair of Eights



PokerStars Zoom Hand #210169705945:  Hold'em No Limit (€0.01/€0.02) - 2020/03/15 19:27:50 CET [2020/03/15 14:27:50 ET]
Table 'Arneb' 6-max Seat #1 is the button
Seat 1: ToniMarteens (€3.37 in chips)
Seat 2: al118360 (€2.36 in chips)
Seat 3: ElvasSniper (€3.84 in chips)
Seat 4: unounoporfavor (€5.53 in chips)
Seat 5: !JAT!989 (€2 in chips)
Seat 6: Luckers712 (€4.27 in chips)
al118360: posts small blind €0.01
ElvasSniper: posts big blind €0.02
*** HOLE CARDS ***
Dealt to Luckers712 [Td Kd]
unounoporfavor: folds
!JAT!989: calls €0.02
Luckers712: raises €0.05 to €0.07
ToniMarteens: folds
al118360: folds
ElvasSniper: folds
!JAT!989: calls €0.05
*** FLOP *** [Ac Ks 7c]
!JAT!989: checks
Luckers712: checks
*** TURN *** [Ac Ks 7c] [As]
!JAT!989: checks
Luckers712: bets €0.11
!JAT!989: folds
Uncalled bet (€0.11) returned to Luckers712
Luckers712 collected €0.16 from pot
Luckers712: doesn't show hand
*** SUMMARY ***
Total pot €0.17 | Rake €0.01
Board [Ac Ks 7c As]
Seat 1: ToniMarteens (button) folded before Flop (didn't bet)
Seat 2: al118360 (small blind) folded before Flop
Seat 3: ElvasSniper (big blind) folded before Flop
Seat 4: unounoporfavor folded before Flop (didn't bet)
Seat 5: !JAT!989 folded on the Turn
Seat 6: Luckers712 collected (€0.16)



PokerStars Zoom Hand #210169762190:  Hold'em No Limit (€0.01/€0.02) - 2020/03/15 19:28:50 CET [2020/03/15 14:28:50 ET]
Table 'Arneb' 6-max Seat #1 is the button
Seat 1: pcea74 (€1.72 in chips)
Seat 2: Kayfidze (€3.52 in chips)
Seat 3: Shzen8 (€2.22 in chips)
Seat 4: o1o0o1o (€2 in chips)
Seat 5: Jou"Yonfa$" (€2 in chips)
Seat 6: Luckers712 (€4.35 in chips)
Kayfidze: posts small blind €0.01
Shzen8: posts big blind €0.02
*** HOLE CARDS ***
Dealt to Luckers712 [6d 5s]
o1o0o1o: folds
Jou"Yonfa$": folds
Luckers712: folds
pcea74: folds
Kayfidze: raises €0.05 to €0.07
Shzen8: folds
Uncalled bet (€0.05) returned to Kayfidze
Kayfidze collected €0.04 from pot
Kayfidze: doesn't show hand
*** SUMMARY ***
Total pot €0.04 | Rake €0
Seat 1: pcea74 (button) folded before Flop (didn't bet)
Seat 2: Kayfidze (small blind) collected (€0.04)
Seat 3: Shzen8 (big blind) folded before Flop
Seat 4: o1o0o1o folded before Flop (didn't bet)
Seat 5: Jou"Yonfa$" folded before Flop (didn't bet)
Seat 6: Luckers712 folded before Flop (didn't bet)



PokerStars Zoom Hand #210169748971:  Hold'em No Limit (€0.01/€0.02) - 2020/03/15 19:28:36 CET [2020/03/15 14:28:36 ET]
Table 'Arneb' 6-max Seat #1 is the button
Seat 1: freececi (€4.11 in chips)
Seat 2: landocigan (€1.53 in chips)
Seat 3: Pescas21 (€2.67 in chips)
Seat 4: garza2610 (€0.74 in chips)
Seat 5: Luckers712 (€4.36 in chips)
Seat 6: ordisile (€2.31 in chips)
landocigan: posts small blind €0.01
Pescas21: posts big blind €0.02
*** HOLE CARDS ***
Dealt to Luckers712 [4d Ah]
garza2610: calls €0.02
Luckers712: folds
ordisile: folds
freececi: folds
landocigan: calls €0.01
Pescas21: checks
*** FLOP *** [3h 2s Kh]
landocigan: bets €0.02
Pescas21: raises €0.04 to €0.06
garza2610: folds
landocigan: folds
Uncalled bet (€0.04) returned to Pescas21
Pescas21 collected €0.10 from pot
Pescas21: doesn't show hand
*** SUMMARY ***
Total pot €0.10 | Rake €0
Board [3h 2s Kh]
Seat 1: freececi (button) folded before Flop (didn't bet)
Seat 2: landocigan (small blind) folded on the Flop
Seat 3: Pescas21 (big blind) collected (€0.10)
Seat 4: garza2610 folded on the Flop
Seat 5: Luckers712 folded before Flop (didn't bet)
Seat 6: ordisile folded before Flop (didn't bet)



PokerStars Zoom Hand #210169766997:  Hold'em No Limit (€0.01/€0.02) - 2020/03/15 19:28:55 CET [2020/03/15 14:28:55 ET]
Table 'Arneb' 6-max Seat #1 is the button
Seat 1: MaurusT (€2.30 in chips)
Seat 2: unounoporfavor (€5.61 in chips)
Seat 3: Luckers712 (€4.35 in chips)
Seat 4: Patrondixx (€1.09 in chips)
Seat 5: j.cerqueira (€1.96 in chips)
Seat 6: xPeskailla (€2.24 in chips)
unounoporfavor: posts small blind €0.01
Luckers712: posts big blind €0.02
*** HOLE CARDS ***
Dealt to Luckers712 [4s 7s]
Patrondixx: calls €0.02
j.cerqueira: folds
xPeskailla: folds
MaurusT: folds
unounoporfavor: calls €0.01
Luckers712: checks
*** FLOP *** [6h Kd Jd]
unounoporfavor: bets €0.02
Luckers712: folds
Patrondixx: folds
Uncalled bet (€0.02) returned to unounoporfavor
unounoporfavor collected €0.06 from pot
unounoporfavor: doesn't show hand
*** SUMMARY ***
Total pot €0.06 | Rake €0
Board [6h Kd Jd]
Seat 1: MaurusT (button) folded before Flop (didn't bet)
Seat 2: unounoporfavor (small blind) collected (€0.06)
Seat 3: Luckers712 (big blind) folded on the Flop
Seat 4: Patrondixx folded on the Flop
Seat 5: j.cerqueira folded before Flop (didn't bet)
Seat 6: xPeskailla folded before Flop (didn't bet)



PokerStars Zoom Hand #210169753638:  Hold'em No Limit (€0.01/€0.02) - 2020/03/15 19:28:41 CET [2020/03/15 14:28:41 ET]
Table 'Arneb' 6-max Seat #1 is the button
Seat 1: Luckers712 (€4.36 in chips)
Seat 2: jmaigre (€0.77 in chips)
Seat 3: smichet (€1.67 in chips)
Seat 4: Capitan Aab (€2.03 in chips)
Seat 5: martingete (€3.21 in chips)
Seat 6: LuisMatos27 (€2.04 in chips)
jmaigre: posts small blind €0.01
smichet: posts big blind €0.02
*** HOLE CARDS ***
Dealt to Luckers712 [2h Qs]
Capitan Aab: folds
martingete: folds
LuisMatos27: folds
Luckers712: folds
jmaigre: calls €0.01
smichet: raises €0.04 to €0.06
jmaigre: raises €0.71 to €0.77 and is all-in
smichet: folds
Uncalled bet (€0.71) returned to jmaigre
jmaigre collected €0.12 from pot
jmaigre: doesn't show hand
*** SUMMARY ***
Total pot €0.12 | Rake €0
Seat 1: Luckers712 (button) folded before Flop (didn't bet)
Seat 2: jmaigre (small blind) collected (€0.12)
Seat 3: smichet (big blind) folded before Flop
Seat 4: Capitan Aab folded before Flop (didn't bet)
Seat 5: martingete folded before Flop (didn't bet)
Seat 6: LuisMatos27 folded before Flop (didn't bet)



PokerStars Zoom Hand #210169781887:  Hold'em No Limit (€0.01/€0.02) - 2020/03/15 19:29:11 CET [2020/03/15 14:29:11 ET]
Table 'Arneb' 6-max Seat #1 is the button
Seat 1: PITI1231 (€2.09 in chips)
Seat 2: gorgotan (€2.45 in chips)
Seat 3: OA83AO (€3.18 in chips)
Seat 4: Luckers712 (€4.33 in chips)
Seat 5: Seron1023 (€2.06 in chips)
Seat 6: mahale81 (€2.62 in chips)
gorgotan: posts small blind €0.01
OA83AO: posts big blind €0.02
*** HOLE CARDS ***
Dealt to Luckers712 [3c 2h]
Luckers712: folds
Seron1023: folds
mahale81: folds
PITI1231: raises €0.04 to €0.06
gorgotan: folds
OA83AO: folds
Uncalled bet (€0.04) returned to PITI1231
PITI1231 collected €0.05 from pot
PITI1231: doesn't show hand
*** SUMMARY ***
Total pot €0.05 | Rake €0
Seat 1: PITI1231 (button) collected (€0.05)
Seat 2: gorgotan (small blind) folded before Flop
Seat 3: OA83AO (big blind) folded before Flop
Seat 4: Luckers712 folded before Flop (didn't bet)
Seat 5: Seron1023 folded before Flop (didn't bet)
Seat 6: mahale81 folded before Flop (didn't bet)



PokerStars Zoom Hand #210169745212:  Hold'em No Limit (€0.01/€0.02) - 2020/03/15 19:28:32 CET [2020/03/15 14:28:32 ET]
Table 'Arneb' 6-max Seat #1 is the button
Seat 1: Jou"Yonfa$" (€2 in chips)
Seat 2: masquisiera (€2 in chips)
Seat 3: P77100 (€0.64 in chips)
Seat 4: Luckers712 (€4.36 in chips)
Seat 5: Kayfidze (€2.16 in chips)
Seat 6: GorjeJacker (€3.07 in chips)
masquisiera: posts small blind €0.01
P77100: posts big blind €0.02
*** HOLE CARDS ***
Dealt to Luckers712 [Qc 3d]
Luckers712: folds
Kayfidze: raises €0.05 to €0.07
GorjeJacker: calls €0.07
Jou"Yonfa$": folds
masquisiera: folds
P77100: folds
*** FLOP *** [Js 3c 6s]
Kayfidze: bets €0.09
GorjeJacker: calls €0.09
*** TURN *** [Js 3c 6s] [4s]
Kayfidze: checks
GorjeJacker: bets €0.11
Kayfidze: calls €0.11
*** RIVER *** [Js 3c 6s 4s] [Qd]
Kayfidze: checks
GorjeJacker: bets €0.38
Kayfidze: folds
Uncalled bet (€0.38) returned to GorjeJacker
GorjeJacker collected €0.54 from pot
GorjeJacker: doesn't show hand
*** SUMMARY ***
Total pot €0.57 | Rake €0.03
Board [Js 3c 6s 4s Qd]
Seat 1: Jou"Yonfa$" (button) folded before Flop (didn't bet)
Seat 2: masquisiera (small blind) folded before Flop
Seat 3: P77100 (big blind) folded before Flop
Seat 4: Luckers712 folded before Flop (didn't bet)
Seat 5: Kayfidze folded on the River
Seat 6: GorjeJacker collected (€0.54)



PokerStars Zoom Hand #210169785541:  Hold'em No Limit (€0.01/€0.02) - 2020/03/15 19:29:15 CET [2020/03/15 14:29:15 ET]
Table 'Arneb' 6-max Seat #1 is the button
Seat 1: masquisiera (€2.03 in chips)
Seat 2: bilboubou78 (€6.25 in chips)
Seat 3: ordisile (€2.31 in chips)
Seat 4: ERIZOCACHO (€0.82 in chips)
Seat 5: Luckers712 (€4.33 in chips)
Seat 6: Vitorhcsousa (€2.05 in chips)
bilboubou78: posts small blind €0.01
ordisile: posts big blind €0.02
*** HOLE CARDS ***
Dealt to Luckers712 [8h 9s]
ERIZOCACHO: folds
Luckers712: folds
Vitorhcsousa: raises €0.04 to €0.06
masquisiera: folds
bilboubou78: raises €0.14 to €0.20
ordisile: folds
Vitorhcsousa: folds
Uncalled bet (€0.14) returned to bilboubou78
bilboubou78 collected €0.14 from pot
bilboubou78: doesn't show hand
*** SUMMARY ***
Total pot €0.14 | Rake €0
Seat 1: masquisiera (button) folded before Flop (didn't bet)
Seat 2: bilboubou78 (small blind) collected (€0.14)
Seat 3: ordisile (big blind) folded before Flop
Seat 4: ERIZOCACHO folded before Flop (didn't bet)
Seat 5: Luckers712 folded before Flop (didn't bet)
Seat 6: Vitorhcsousa folded before Flop



PokerStars Zoom Hand #210169757406:  Hold'em No Limit (€0.01/€0.02) - 2020/03/15 19:28:45 CET [2020/03/15 14:28:45 ET]
Table 'Arneb' 6-max Seat #1 is the button
Seat 1: Ispea (€0.88 in chips)
Seat 2: Luckers712 (€4.36 in chips)
Seat 3: roms421984 (€0.84 in chips)
Seat 4: unounoporfavor (€10.08 in chips)
Seat 5: Shzen8 (€1.30 in chips)
Seat 6: martingete (€3.21 in chips)
Luckers712: posts small blind €0.01
roms421984: posts big blind €0.02
*** HOLE CARDS ***
Dealt to Luckers712 [Qs 7h]
unounoporfavor: raises €0.02 to €0.04
Shzen8: folds
martingete: folds
Ispea: calls €0.04
Luckers712: folds
roms421984: calls €0.02
*** FLOP *** [Ac Jh Ks]
roms421984: checks
unounoporfavor: bets €0.04
Ispea: folds
roms421984: calls €0.04
*** TURN *** [Ac Jh Ks] [4d]
roms421984: checks
unounoporfavor: bets €0.06
roms421984: calls €0.06
*** RIVER *** [Ac Jh Ks 4d] [3h]
roms421984: checks
unounoporfavor: checks
*** SHOW DOWN ***
roms421984: shows [9c Qc] (high card Ace)
unounoporfavor: shows [Kc Qh] (a pair of Kings)
unounoporfavor collected €0.31 from pot
*** SUMMARY ***
Total pot €0.33 | Rake €0.02
Board [Ac Jh Ks 4d 3h]
Seat 1: Ispea (button) folded on the Flop
Seat 2: Luckers712 (small blind) folded before Flop
Seat 3: roms421984 (big blind) showed [9c Qc] and lost with high card Ace
Seat 4: unounoporfavor showed [Kc Qh] and won (€0.31) with a pair of Kings
Seat 5: Shzen8 folded before Flop (didn't bet)
Seat 6: martingete folded before Flop (didn't bet)



PokerStars Zoom Hand #210169792168:  Hold'em No Limit (€0.01/€0.02) - 2020/03/15 19:29:22 CET [2020/03/15 14:29:22 ET]
Table 'Arneb' 6-max Seat #1 is the button
Seat 1: Luckers712 (€4.33 in chips)
Seat 2: Leandro Silva 8 (€0.98 in chips)
Seat 3: carapaça (€1.55 in chips)
Seat 4: Seron1023 (€2.45 in chips)
Seat 5: clapo44980 (€0.79 in chips)
Seat 6: jonnyelbridas2 (€1.08 in chips)
Leandro Silva 8: posts small blind €0.01
carapaça: posts big blind €0.02
*** HOLE CARDS ***
Dealt to Luckers712 [Ts Kh]
Seron1023: folds
clapo44980: folds
jonnyelbridas2: folds
Luckers712: raises €0.03 to €0.05
Leandro Silva 8: calls €0.04
carapaça: folds
*** FLOP *** [6s 2h 8h]
Leandro Silva 8: checks
Luckers712: checks
*** TURN *** [6s 2h 8h] [9s]
Leandro Silva 8: checks
Luckers712: checks
*** RIVER *** [6s 2h 8h 9s] [Kc]
Leandro Silva 8: checks
Luckers712: bets €0.08
Leandro Silva 8: folds
Uncalled bet (€0.08) returned to Luckers712
Luckers712 collected €0.11 from pot
Luckers712: doesn't show hand
*** SUMMARY ***
Total pot €0.12 | Rake €0.01
Board [6s 2h 8h 9s Kc]
Seat 1: Luckers712 (button) collected (€0.11)
Seat 2: Leandro Silva 8 (small blind) folded on the River
Seat 3: carapaça (big blind) folded before Flop
Seat 4: Seron1023 folded before Flop (didn't bet)
Seat 5: clapo44980 folded before Flop (didn't bet)
Seat 6: jonnyelbridas2 folded before Flop (didn't bet)



PokerStars Zoom Hand #210169838273:  Hold'em No Limit (€0.01/€0.02) - 2020/03/15 19:30:11 CET [2020/03/15 14:30:11 ET]
Table 'Arneb' 6-max Seat #1 is the button
Seat 1: Ballagarey (€2 in chips)
Seat 2: Luckers712 (€4.39 in chips)
Seat 3: clapo44980 (€0.75 in chips)
Seat 4: bea_morena19 (€1.92 in chips)
Seat 5: PITI1231 (€8.15 in chips)
Seat 6: Vitorhcsousa (€3.76 in chips)
Luckers712: posts small blind €0.01
clapo44980: posts big blind €0.02
*** HOLE CARDS ***
Dealt to Luckers712 [Th Kh]
bea_morena19: folds
PITI1231: folds
Vitorhcsousa: folds
Ballagarey: folds
Luckers712: raises €0.04 to €0.06
clapo44980: folds
Uncalled bet (€0.04) returned to Luckers712
Luckers712 collected €0.04 from pot
Luckers712: doesn't show hand
*** SUMMARY ***
Total pot €0.04 | Rake €0
Seat 1: Ballagarey (button) folded before Flop (didn't bet)
Seat 2: Luckers712 (small blind) collected (€0.04)
Seat 3: clapo44980 (big blind) folded before Flop
Seat 4: bea_morena19 folded before Flop (didn't bet)
Seat 5: PITI1231 folded before Flop (didn't bet)
Seat 6: Vitorhcsousa folded before Flop (didn't bet)



PokerStars Zoom Hand #210169834240:  Hold'em No Limit (€0.01/€0.02) - 2020/03/15 19:30:07 CET [2020/03/15 14:30:07 ET]
Table 'Arneb' 6-max Seat #1 is the button
Seat 1: KALASH71 (€1.33 in chips)
Seat 2: priscalina (€0.98 in chips)
Seat 3: Warritos (€2.67 in chips)
Seat 4: Luckers712 (€4.39 in chips)
Seat 5: xPeskailla (€2.37 in chips)
Seat 6: Lbrt911 (€1 in chips)
priscalina: posts small blind €0.01
Warritos: posts big blind €0.02
*** HOLE CARDS ***
Dealt to Luckers712 [Jd 9c]
Luckers712: folds
xPeskailla: raises €0.04 to €0.06
Lbrt911: folds
KALASH71: folds
priscalina: calls €0.05
Warritos: folds
*** FLOP *** [6h 3c Kc]
priscalina: checks
xPeskailla: bets €0.03
priscalina: folds
Uncalled bet (€0.03) returned to xPeskailla
xPeskailla collected €0.13 from pot
xPeskailla: doesn't show hand
*** SUMMARY ***
Total pot €0.14 | Rake €0.01
Board [6h 3c Kc]
Seat 1: KALASH71 (button) folded before Flop (didn't bet)
Seat 2: priscalina (small blind) folded on the Flop
Seat 3: Warritos (big blind) folded before Flop
Seat 4: Luckers712 folded before Flop (didn't bet)
Seat 5: xPeskailla collected (€0.13)
Seat 6: Lbrt911 folded before Flop (didn't bet)



PokerStars Zoom Hand #210169865894:  Hold'em No Limit (€0.01/€0.02) - 2020/03/15 19:30:40 CET [2020/03/15 14:30:40 ET]
Table 'Arneb' 6-max Seat #1 is the button
Seat 1: priscalina (€0.92 in chips)
Seat 2: cad1959 (€1.97 in chips)
Seat 3: Veesile (€2 in chips)
Seat 4: petitgold (€2 in chips)
Seat 5: Luckers712 (€4.41 in chips)
Seat 6: squall2009 (€0.97 in chips)
cad1959: posts small blind €0.01
Veesile: posts big blind €0.02
*** HOLE CARDS ***
Dealt to Luckers712 [6c 6d]
petitgold: folds
Luckers712: raises €0.03 to €0.05
squall2009: folds
priscalina: calls €0.05
cad1959: folds
Veesile: folds
*** FLOP *** [5h Kc 9c]
Luckers712: checks
priscalina: checks
*** TURN *** [5h Kc 9c] [6s]
Luckers712: checks
priscalina: checks
*** RIVER *** [5h Kc 9c 6s] [9s]
Luckers712: checks
priscalina: checks
*** SHOW DOWN ***
Luckers712: shows [6c 6d] (a full house, Sixes full of Nines)
priscalina: mucks hand
Luckers712 collected €0.12 from pot
*** SUMMARY ***
Total pot €0.13 | Rake €0.01
Board [5h Kc 9c 6s 9s]
Seat 1: priscalina (button) mucked [Jh 8h]
Seat 2: cad1959 (small blind) folded before Flop
Seat 3: Veesile (big blind) folded before Flop
Seat 4: petitgold folded before Flop (didn't bet)
Seat 5: Luckers712 showed [6c 6d] and won (€0.12) with a full house, Sixes full of Nines
Seat 6: squall2009 folded before Flop (didn't bet)



PokerStars Zoom Hand #210169907718:  Hold'em No Limit (€0.01/€0.02) - 2020/03/15 19:31:26 CET [2020/03/15 14:31:26 ET]
Table 'Arneb' 6-max Seat #1 is the button
Seat 1: cocololo91 (€6.28 in chips)
Seat 2: Sanee1992 (€4.35 in chips)
Seat 3: Titan467 (€1 in chips)
Seat 4: Mad Sputnik (€1.99 in chips)
Seat 5: walowz (€1.97 in chips)
Seat 6: Luckers712 (€4.48 in chips)
Sanee1992: posts small blind €0.01
Titan467: posts big blind €0.02
*** HOLE CARDS ***
Dealt to Luckers712 [8d 5d]
Mad Sputnik: folds
walowz: folds
Luckers712: raises €0.03 to €0.05
cocololo91: folds
Sanee1992: calls €0.04
Titan467: calls €0.03
*** FLOP *** [2h Jc Ah]
Sanee1992: bets €0.02
Titan467: calls €0.02
Luckers712: raises €0.18 to €0.20
Sanee1992: folds
Titan467: folds
Uncalled bet (€0.18) returned to Luckers712
Luckers712 collected €0.20 from pot
Luckers712: doesn't show hand
*** SUMMARY ***
Total pot €0.21 | Rake €0.01
Board [2h Jc Ah]
Seat 1: cocololo91 (button) folded before Flop (didn't bet)
Seat 2: Sanee1992 (small blind) folded on the Flop
Seat 3: Titan467 (big blind) folded on the Flop
Seat 4: Mad Sputnik folded before Flop (didn't bet)
Seat 5: walowz folded before Flop (didn't bet)
Seat 6: Luckers712 collected (€0.20)



PokerStars Zoom Hand #210169958560:  Hold'em No Limit (€0.01/€0.02) - 2020/03/15 19:32:20 CET [2020/03/15 14:32:20 ET]
Table 'Arneb' 6-max Seat #1 is the button
Seat 1: campanilla06 (€2.81 in chips)
Seat 2: Mad Sputnik (€1.95 in chips)
Seat 3: Fredus73 (€2.87 in chips)
Seat 4: Luckers712 (€4.61 in chips)
Seat 5: TheKing11597 (€2.02 in chips)
Seat 6: Marlock10 (€1 in chips)
Mad Sputnik: posts small blind €0.01
Fredus73: posts big blind €0.02
*** HOLE CARDS ***
Dealt to Luckers712 [6c Ts]
Luckers712: folds
TheKing11597: folds
Marlock10: raises €0.02 to €0.04
campanilla06: folds
Mad Sputnik: folds
Fredus73: folds
Uncalled bet (€0.02) returned to Marlock10
Marlock10 collected €0.05 from pot
Marlock10: doesn't show hand
*** SUMMARY ***
Total pot €0.05 | Rake €0
Seat 1: campanilla06 (button) folded before Flop (didn't bet)
Seat 2: Mad Sputnik (small blind) folded before Flop
Seat 3: Fredus73 (big blind) folded before Flop
Seat 4: Luckers712 folded before Flop (didn't bet)
Seat 5: TheKing11597 folded before Flop (didn't bet)
Seat 6: Marlock10 collected (€0.05)



PokerStars Zoom Hand #210169962420:  Hold'em No Limit (€0.01/€0.02) - 2020/03/15 19:32:24 CET [2020/03/15 14:32:24 ET]
Table 'Arneb' 6-max Seat #1 is the button
Seat 1: Ballagarey (€2.06 in chips)
Seat 2: Baby Alligator (€3.38 in chips)
Seat 3: Luckers712 (€4.61 in chips)
Seat 4: chiwas12 (€6.28 in chips)
Seat 5: amotinado85 (€2.36 in chips)
Seat 6: jzamora2011 (€6.53 in chips)
Baby Alligator: posts small blind €0.01
Luckers712: posts big blind €0.02
*** HOLE CARDS ***
Dealt to Luckers712 [Jc 2d]
chiwas12: folds
amotinado85: folds
jzamora2011: folds
Ballagarey: folds
Baby Alligator: raises €0.04 to €0.06
Luckers712: folds
Uncalled bet (€0.04) returned to Baby Alligator
Baby Alligator collected €0.04 from pot
Baby Alligator: doesn't show hand
*** SUMMARY ***
Total pot €0.04 | Rake €0
Seat 1: Ballagarey (button) folded before Flop (didn't bet)
Seat 2: Baby Alligator (small blind) collected (€0.04)
Seat 3: Luckers712 (big blind) folded before Flop
Seat 4: chiwas12 folded before Flop (didn't bet)
Seat 5: amotinado85 folded before Flop (didn't bet)
Seat 6: jzamora2011 folded before Flop (didn't bet)



PokerStars Zoom Hand #210169977346:  Hold'em No Limit (€0.01/€0.02) - 2020/03/15 19:32:40 CET [2020/03/15 14:32:40 ET]
Table 'Arneb' 6-max Seat #1 is the button
Seat 1: Oll1Deloin (€2.11 in chips)
Seat 2: Leandro Silva 8 (€0.81 in chips)
Seat 3: xPeskailla (€2.29 in chips)
Seat 4: Luckers712 (€4.59 in chips)
Seat 5: aportiquevoy (€2.06 in chips)
Seat 6: raptureman1 (€2 in chips)
Leandro Silva 8: posts small blind €0.01
xPeskailla: posts big blind €0.02
*** HOLE CARDS ***
Dealt to Luckers712 [Kh Kd]
Luckers712: raises €0.04 to €0.06
aportiquevoy: calls €0.06
raptureman1: folds
Oll1Deloin: folds
Leandro Silva 8: folds
xPeskailla: folds
*** FLOP *** [2c Kc 4c]
Luckers712: checks
aportiquevoy: checks
*** TURN *** [2c Kc 4c] [6s]
Luckers712: bets €0.09
aportiquevoy: folds
Uncalled bet (€0.09) returned to Luckers712
Luckers712 collected €0.14 from pot
Luckers712: doesn't show hand
*** SUMMARY ***
Total pot €0.15 | Rake €0.01
Board [2c Kc 4c 6s]
Seat 1: Oll1Deloin (button) folded before Flop (didn't bet)
Seat 2: Leandro Silva 8 (small blind) folded before Flop
Seat 3: xPeskailla (big blind) folded before Flop
Seat 4: Luckers712 collected (€0.14)
Seat 5: aportiquevoy folded on the Turn
Seat 6: raptureman1 folded before Flop (didn't bet)



PokerStars Zoom Hand #210170041113:  Hold'em No Limit (€0.01/€0.02) - 2020/03/15 19:33:47 CET [2020/03/15 14:33:47 ET]
Table 'Arneb' 6-max Seat #1 is the button
Seat 1: TheKing11597 (€3.87 in chips)
Seat 2: Luckers712 (€4.67 in chips)
Seat 3: Veesile (€3.88 in chips)
Seat 4: MMMJLMALM (€4.32 in chips)
Seat 5: campanilla06 (€1.61 in chips)
Seat 6: LuisMatos27 (€4.06 in chips)
Luckers712: posts small blind €0.01
Veesile: posts big blind €0.02
*** HOLE CARDS ***
Dealt to Luckers712 [2d Tc]
MMMJLMALM: folds
campanilla06: folds
LuisMatos27: raises €0.03 to €0.05
TheKing11597: folds
Luckers712: folds
Veesile: folds
Uncalled bet (€0.03) returned to LuisMatos27
LuisMatos27 collected €0.05 from pot
LuisMatos27: doesn't show hand
*** SUMMARY ***
Total pot €0.05 | Rake €0
Seat 1: TheKing11597 (button) folded before Flop (didn't bet)
Seat 2: Luckers712 (small blind) folded before Flop
Seat 3: Veesile (big blind) folded before Flop
Seat 4: MMMJLMALM folded before Flop (didn't bet)
Seat 5: campanilla06 folded before Flop (didn't bet)
Seat 6: LuisMatos27 collected (€0.05)



PokerStars Zoom Hand #210170044985:  Hold'em No Limit (€0.01/€0.02) - 2020/03/15 19:33:51 CET [2020/03/15 14:33:51 ET]
Table 'Arneb' 6-max Seat #1 is the button
Seat 1: Poyo169 (€1.25 in chips)
Seat 2: Chunclis (€4.33 in chips)
Seat 3: Luckers712 (€4.66 in chips)
Seat 4: derbedeu0 (€0.64 in chips)
Seat 5: OA83AO (€5.72 in chips)
Seat 6: galodebarcelos (€4.30 in chips)
Chunclis: posts small blind €0.01
Luckers712: posts big blind €0.02
*** HOLE CARDS ***
Dealt to Luckers712 [8c 6c]
derbedeu0: folds
OA83AO: folds
galodebarcelos: raises €0.04 to €0.06
Poyo169: folds
Chunclis: folds
Luckers712: raises €0.14 to €0.20
galodebarcelos: folds
Uncalled bet (€0.14) returned to Luckers712
Luckers712 collected €0.13 from pot
Luckers712: doesn't show hand
*** SUMMARY ***
Total pot €0.13 | Rake €0
Seat 1: Poyo169 (button) folded before Flop (didn't bet)
Seat 2: Chunclis (small blind) folded before Flop
Seat 3: Luckers712 (big blind) collected (€0.13)
Seat 4: derbedeu0 folded before Flop (didn't bet)
Seat 5: OA83AO folded before Flop (didn't bet)
Seat 6: galodebarcelos folded before Flop



PokerStars Zoom Hand #210170066792:  Hold'em No Limit (€0.01/€0.02) - 2020/03/15 19:34:14 CET [2020/03/15 14:34:14 ET]
Table 'Arneb' 6-max Seat #1 is the button
Seat 1: Luckers712 (€4.73 in chips)
Seat 2: campanilla06 (€2.10 in chips)
Seat 3: lucky13re (€2 in chips)
Seat 4: M5dias (€3.91 in chips)
Seat 5: Jesuscb88 (€1.09 in chips)
Seat 6: pcea74 (€1.84 in chips)
campanilla06: posts small blind €0.01
lucky13re: posts big blind €0.02
*** HOLE CARDS ***
Dealt to Luckers712 [7c 6d]
M5dias: raises €0.04 to €0.06
Jesuscb88: folds
pcea74: folds
Luckers712: folds
campanilla06: folds
lucky13re: folds
Uncalled bet (€0.04) returned to M5dias
M5dias collected €0.05 from pot
M5dias: doesn't show hand
*** SUMMARY ***
Total pot €0.05 | Rake €0
Seat 1: Luckers712 (button) folded before Flop (didn't bet)
Seat 2: campanilla06 (small blind) folded before Flop
Seat 3: lucky13re (big blind) folded before Flop
Seat 4: M5dias collected (€0.05)
Seat 5: Jesuscb88 folded before Flop (didn't bet)
Seat 6: pcea74 folded before Flop (didn't bet)



PokerStars Zoom Hand #210170076261:  Hold'em No Limit (€0.01/€0.02) - 2020/03/15 19:34:24 CET [2020/03/15 14:34:24 ET]
Table 'Arneb' 6-max Seat #1 is the button
Seat 1: Luckers712 (€4.73 in chips)
Seat 2: Miltonmoreno (€2.12 in chips)
Seat 3: Ballagarey (€4.16 in chips)
Seat 4: ChaCha120488 (€0.58 in chips)
Seat 5: KALASH71 (€1.30 in chips)
Seat 6: chiwas12 (€2 in chips)
Miltonmoreno: posts small blind €0.01
Ballagarey: posts big blind €0.02
*** HOLE CARDS ***
Dealt to Luckers712 [Ac 4s]
ChaCha120488: folds
KALASH71: folds
chiwas12: folds
Luckers712: raises €0.04 to €0.06
Miltonmoreno: folds
Ballagarey: folds
Uncalled bet (€0.04) returned to Luckers712
Luckers712 collected €0.05 from pot
Luckers712: doesn't show hand
*** SUMMARY ***
Total pot €0.05 | Rake €0
Seat 1: Luckers712 (button) collected (€0.05)
Seat 2: Miltonmoreno (small blind) folded before Flop
Seat 3: Ballagarey (big blind) folded before Flop
Seat 4: ChaCha120488 folded before Flop (didn't bet)
Seat 5: KALASH71 folded before Flop (didn't bet)
Seat 6: chiwas12 folded before Flop (didn't bet)



PokerStars Zoom Hand #210170070550:  Hold'em No Limit (€0.01/€0.02) - 2020/03/15 19:34:18 CET [2020/03/15 14:34:18 ET]
Table 'Arneb' 6-max Seat #1 is the button
Seat 1: Comino79 (€1.89 in chips)
Seat 2: bilboubou78 (€1.79 in chips)
Seat 3: amotinado85 (€2.31 in chips)
Seat 4: landocigan (€1.43 in chips)
Seat 5: Oll1Deloin (€2.14 in chips)
Seat 6: Luckers712 (€4.73 in chips)
bilboubou78: posts small blind €0.01
amotinado85: posts big blind €0.02
*** HOLE CARDS ***
Dealt to Luckers712 [Ah 3c]
landocigan: folds
Oll1Deloin: folds
Luckers712: folds
Comino79: folds
bilboubou78: raises €0.04 to €0.06
amotinado85: calls €0.04
*** FLOP *** [Ks 5h 2h]
bilboubou78: bets €0.06
amotinado85: calls €0.06
*** TURN *** [Ks 5h 2h] [5s]
bilboubou78: bets €0.12
amotinado85: calls €0.12
*** RIVER *** [Ks 5h 2h 5s] [7h]
bilboubou78: checks
amotinado85: checks
*** SHOW DOWN ***
bilboubou78: shows [Js Jh] (two pair, Jacks and Fives)
amotinado85: shows [Kc 9h] (two pair, Kings and Fives)
amotinado85 collected €0.46 from pot
*** SUMMARY ***
Total pot €0.48 | Rake €0.02
Board [Ks 5h 2h 5s 7h]
Seat 1: Comino79 (button) folded before Flop (didn't bet)
Seat 2: bilboubou78 (small blind) showed [Js Jh] and lost with two pair, Jacks and Fives
Seat 3: amotinado85 (big blind) showed [Kc 9h] and won (€0.46) with two pair, Kings and Fives
Seat 4: landocigan folded before Flop (didn't bet)
Seat 5: Oll1Deloin folded before Flop (didn't bet)
Seat 6: Luckers712 folded before Flop (didn't bet)



PokerStars Zoom Hand #210170104092:  Hold'em No Limit (€0.01/€0.02) - 2020/03/15 19:34:53 CET [2020/03/15 14:34:53 ET]
Table 'Arneb' 6-max Seat #1 is the button
Seat 1: NanoLMP (€2.28 in chips)
Seat 2: soulfunk1 (€2.09 in chips)
Seat 3: bilboubou78 (€3.94 in chips)
Seat 4: R1p-j (€4.87 in chips)
Seat 5: Luckers712 (€4.76 in chips)
Seat 6: lucky13re (€2.08 in chips)
soulfunk1: posts small blind €0.01
bilboubou78: posts big blind €0.02
*** HOLE CARDS ***
Dealt to Luckers712 [2h 6h]
R1p-j: folds
Luckers712: folds
lucky13re: folds
NanoLMP: raises €0.03 to €0.05
soulfunk1: raises €0.15 to €0.20
bilboubou78: folds
NanoLMP: folds
Uncalled bet (€0.15) returned to soulfunk1
soulfunk1 collected €0.12 from pot
soulfunk1: doesn't show hand
*** SUMMARY ***
Total pot €0.12 | Rake €0
Seat 1: NanoLMP (button) folded before Flop
Seat 2: soulfunk1 (small blind) collected (€0.12)
Seat 3: bilboubou78 (big blind) folded before Flop
Seat 4: R1p-j folded before Flop (didn't bet)
Seat 5: Luckers712 folded before Flop (didn't bet)
Seat 6: lucky13re folded before Flop (didn't bet)



PokerStars Zoom Hand #210170098373:  Hold'em No Limit (€0.01/€0.02) - 2020/03/15 19:34:47 CET [2020/03/15 14:34:47 ET]
Table 'Arneb' 6-max Seat #1 is the button
Seat 1: centrocastillo (€2.20 in chips)
Seat 2: amotinado85 (€2.65 in chips)
Seat 3: OA83AO (€3.08 in chips)
Seat 4: recis (€2.92 in chips)
Seat 5: Luckers712 (€4.76 in chips)
Seat 6: Markitos PT (€2.19 in chips)
amotinado85: posts small blind €0.01
OA83AO: posts big blind €0.02
*** HOLE CARDS ***
Dealt to Luckers712 [2c Qc]
recis: folds
Luckers712: folds
Markitos PT: calls €0.02
centrocastillo: folds
amotinado85: folds
OA83AO: checks
*** FLOP *** [3d Ks 9s]
OA83AO: checks
Markitos PT: checks
*** TURN *** [3d Ks 9s] [Kd]
OA83AO: bets €0.04
Markitos PT: calls €0.04
*** RIVER *** [3d Ks 9s Kd] [5c]
OA83AO: bets €0.09
Markitos PT: raises €0.11 to €0.20
OA83AO: calls €0.11
*** SHOW DOWN ***
Markitos PT: shows [3h Kh] (a full house, Kings full of Threes)
OA83AO: mucks hand
Markitos PT collected €0.50 from pot
*** SUMMARY ***
Total pot €0.53 | Rake €0.03
Board [3d Ks 9s Kd 5c]
Seat 1: centrocastillo (button) folded before Flop (didn't bet)
Seat 2: amotinado85 (small blind) folded before Flop
Seat 3: OA83AO (big blind) mucked [Kc Th]
Seat 4: recis folded before Flop (didn't bet)
Seat 5: Luckers712 folded before Flop (didn't bet)
Seat 6: Markitos PT showed [3h Kh] and won (€0.50) with a full house, Kings full of Threes



PokerStars Zoom Hand #210170116596:  Hold'em No Limit (€0.01/€0.02) - 2020/03/15 19:35:06 CET [2020/03/15 14:35:06 ET]
Table 'Arneb' 6-max Seat #1 is the button
Seat 1: Veesile (€2.58 in chips)
Seat 2: Warritos (€2.30 in chips)
Seat 3: Luckers712 (€4.75 in chips)
Seat 4: israel476 (€2.69 in chips)
Seat 5: aportiquevoy (€2.10 in chips)
Seat 6: Marlock10 (€1.08 in chips)
Warritos: posts small blind €0.01
Luckers712: posts big blind €0.02
*** HOLE CARDS ***
Dealt to Luckers712 [Th 2h]
israel476: raises €0.04 to €0.06
aportiquevoy: folds
Marlock10: folds
Veesile: calls €0.06
Warritos: folds
Luckers712: folds
*** FLOP *** [8s 4d Kh]
israel476: checks
Veesile: bets €0.04
israel476: calls €0.04
*** TURN *** [8s 4d Kh] [As]
israel476: checks
Veesile: checks
*** RIVER *** [8s 4d Kh As] [4c]
israel476: bets €0.12
Veesile: folds
Uncalled bet (€0.12) returned to israel476
israel476 collected €0.22 from pot
israel476: doesn't show hand
*** SUMMARY ***
Total pot €0.23 | Rake €0.01
Board [8s 4d Kh As 4c]
Seat 1: Veesile (button) folded on the River
Seat 2: Warritos (small blind) folded before Flop
Seat 3: Luckers712 (big blind) folded before Flop
Seat 4: israel476 collected (€0.22)
Seat 5: aportiquevoy folded before Flop (didn't bet)
Seat 6: Marlock10 folded before Flop (didn't bet)



PokerStars Zoom Hand #210170107945:  Hold'em No Limit (€0.01/€0.02) - 2020/03/15 19:34:57 CET [2020/03/15 14:34:57 ET]
Table 'Arneb' 6-max Seat #1 is the button
Seat 1: GorjeJacker (€2.75 in chips)
Seat 2: Luckers712 (€4.76 in chips)
Seat 3: usskul_44 (€1 in chips)
Seat 4: Carma312 (€1.70 in chips)
Seat 5: Warritos (€2.30 in chips)
Seat 6: Lbrt911 (€1.09 in chips)
Luckers712: posts small blind €0.01
usskul_44: posts big blind €0.02
*** HOLE CARDS ***
Dealt to Luckers712 [2h Th]
Carma312: folds
Warritos: folds
Lbrt911: folds
GorjeJacker: raises €0.03 to €0.05
Luckers712: folds
usskul_44: calls €0.03
*** FLOP *** [Ah 9c 2c]
usskul_44: checks
GorjeJacker: bets €0.04
usskul_44: calls €0.04
*** TURN *** [Ah 9c 2c] [6d]
usskul_44: checks
GorjeJacker: bets €0.14
usskul_44: calls €0.14
*** RIVER *** [Ah 9c 2c 6d] [2s]
usskul_44: checks
GorjeJacker: checks
*** SHOW DOWN ***
usskul_44: shows [8d Ac] (two pair, Aces and Deuces)
GorjeJacker: shows [Ad Js] (two pair, Aces and Deuces - Jack kicker)
GorjeJacker collected €0.45 from pot
*** SUMMARY ***
Total pot €0.47 | Rake €0.02
Board [Ah 9c 2c 6d 2s]
Seat 1: GorjeJacker (button) showed [Ad Js] and won (€0.45) with two pair, Aces and Deuces
Seat 2: Luckers712 (small blind) folded before Flop
Seat 3: usskul_44 (big blind) showed [8d Ac] and lost with two pair, Aces and Deuces
Seat 4: Carma312 folded before Flop (didn't bet)
Seat 5: Warritos folded before Flop (didn't bet)
Seat 6: Lbrt911 folded before Flop (didn't bet)



PokerStars Zoom Hand #210170121467:  Hold'em No Limit (€0.01/€0.02) - 2020/03/15 19:35:11 CET [2020/03/15 14:35:11 ET]
Table 'Arneb' 6-max Seat #1 is the button
Seat 1: ivan_ojuelo (€1.26 in chips)
Seat 2: Romanshev (€2 in chips)
Seat 3: ceronalemany (€1.33 in chips)
Seat 4: MDKristian (€1.75 in chips)
Seat 5: perolete66 (€2.20 in chips)
Seat 6: Luckers712 (€4.73 in chips)
Romanshev: posts small blind €0.01
ceronalemany: posts big blind €0.02
*** HOLE CARDS ***
Dealt to Luckers712 [2c Qs]
MDKristian: folds
perolete66: raises €0.03 to €0.05
Luckers712: folds
ivan_ojuelo: folds
Romanshev: calls €0.04
ceronalemany: calls €0.03
*** FLOP *** [3c 4d Js]
Romanshev: checks
ceronalemany: checks
perolete66: checks
*** TURN *** [3c 4d Js] [Qc]
Romanshev: checks
ceronalemany: bets €0.14
perolete66: folds
Romanshev: folds
Uncalled bet (€0.14) returned to ceronalemany
ceronalemany collected €0.14 from pot
ceronalemany: doesn't show hand
*** SUMMARY ***
Total pot €0.15 | Rake €0.01
Board [3c 4d Js Qc]
Seat 1: ivan_ojuelo (button) folded before Flop (didn't bet)
Seat 2: Romanshev (small blind) folded on the Turn
Seat 3: ceronalemany (big blind) collected (€0.14)
Seat 4: MDKristian folded before Flop (didn't bet)
Seat 5: perolete66 folded on the Turn
Seat 6: Luckers712 folded before Flop (didn't bet)



PokerStars Zoom Hand #210170112750:  Hold'em No Limit (€0.01/€0.02) - 2020/03/15 19:35:02 CET [2020/03/15 14:35:02 ET]
Table 'Arneb' 6-max Seat #1 is the button
Seat 1: OA83AO (€3.24 in chips)
Seat 2: SonsOfFun (€2.51 in chips)
Seat 3: M5dias (€2.15 in chips)
Seat 4: tulcio (€2.38 in chips)
Seat 5: Luckers712 (€4.75 in chips)
Seat 6: Capitan Aab (€2.28 in chips)
SonsOfFun: posts small blind €0.01
M5dias: posts big blind €0.02
*** HOLE CARDS ***
Dealt to Luckers712 [4c 6s]
tulcio: folds
Luckers712: folds
Capitan Aab: raises €0.02 to €0.04
OA83AO: folds
SonsOfFun: raises €0.12 to €0.16
M5dias: calls €0.14
Capitan Aab: folds
*** FLOP *** [2s Qc 2c]
SonsOfFun: checks
M5dias: checks
*** TURN *** [2s Qc 2c] [3h]
SonsOfFun: bets €0.17
M5dias: calls €0.17
*** RIVER *** [2s Qc 2c 3h] [Ad]
SonsOfFun: bets €0.50
M5dias: raises €0.94 to €1.44
SonsOfFun: folds
Uncalled bet (€0.94) returned to M5dias
M5dias collected €1.62 from pot
M5dias: doesn't show hand
*** SUMMARY ***
Total pot €1.70 | Rake €0.08
Board [2s Qc 2c 3h Ad]
Seat 1: OA83AO (button) folded before Flop (didn't bet)
Seat 2: SonsOfFun (small blind) folded on the River
Seat 3: M5dias (big blind) collected (€1.62)
Seat 4: tulcio folded before Flop (didn't bet)
Seat 5: Luckers712 folded before Flop (didn't bet)
Seat 6: Capitan Aab folded before Flop



PokerStars Zoom Hand #210170126209:  Hold'em No Limit (€0.01/€0.02) - 2020/03/15 19:35:16 CET [2020/03/15 14:35:16 ET]
Table 'Arneb' 6-max Seat #1 is the button
Seat 1: Luckers712 (€4.73 in chips)
Seat 2: Oll1Deloin (€2.15 in chips)
Seat 3: El moro78 (€3.50 in chips)
Seat 4: Patrondixx (€2.29 in chips)
Seat 5: tulcio (€2.28 in chips)
Seat 6: chiwas12 (€6.30 in chips)
Oll1Deloin: posts small blind €0.01
El moro78: posts big blind €0.02
*** HOLE CARDS ***
Dealt to Luckers712 [8d Js]
Patrondixx: calls €0.02
tulcio: folds
chiwas12: folds
Luckers712: calls €0.02
Oll1Deloin: folds
El moro78: checks
*** FLOP *** [7s Ts Th]
El moro78: checks
Patrondixx: checks
Luckers712: checks
*** TURN *** [7s Ts Th] [8h]
El moro78: checks
Patrondixx: bets €0.02
Luckers712: calls €0.02
El moro78: calls €0.02
*** RIVER *** [7s Ts Th 8h] [9c]
El moro78: checks
Patrondixx: checks
Luckers712: bets €0.08
El moro78: folds
Patrondixx: calls €0.08
*** SHOW DOWN ***
Luckers712: shows [8d Js] (a straight, Seven to Jack)
Patrondixx: mucks hand
Luckers712 collected €0.28 from pot
*** SUMMARY ***
Total pot €0.29 | Rake €0.01
Board [7s Ts Th 8h 9c]
Seat 1: Luckers712 (button) showed [8d Js] and won (€0.28) with a straight, Seven to Jack
Seat 2: Oll1Deloin (small blind) folded before Flop
Seat 3: El moro78 (big blind) folded on the River
Seat 4: Patrondixx mucked [Ac 3h]
Seat 5: tulcio folded before Flop (didn't bet)
Seat 6: chiwas12 folded before Flop (didn't bet)



PokerStars Zoom Hand #210170226198:  Hold'em No Limit (€0.01/€0.02) - 2020/03/15 19:37:01 CET [2020/03/15 14:37:01 ET]
Table 'Arneb' 6-max Seat #1 is the button
Seat 1: ERIZOCACHO (€1.44 in chips)
Seat 2: Luckers712 (€4.89 in chips)
Seat 3: campanilla06 (€3.21 in chips)
Seat 4: clapo44980 (€1.80 in chips)
Seat 5: javigarrido8 (€1.14 in chips)
Seat 6: lucky13re (€2 in chips)
Luckers712: posts small blind €0.01
campanilla06: posts big blind €0.02
*** HOLE CARDS ***
Dealt to Luckers712 [Ks Qs]
clapo44980: folds
javigarrido8: folds
lucky13re: folds
ERIZOCACHO: folds
Luckers712: raises €0.04 to €0.06
campanilla06: folds
Uncalled bet (€0.04) returned to Luckers712
Luckers712 collected €0.04 from pot
Luckers712: doesn't show hand
*** SUMMARY ***
Total pot €0.04 | Rake €0
Seat 1: ERIZOCACHO (button) folded before Flop (didn't bet)
Seat 2: Luckers712 (small blind) collected (€0.04)
Seat 3: campanilla06 (big blind) folded before Flop
Seat 4: clapo44980 folded before Flop (didn't bet)
Seat 5: javigarrido8 folded before Flop (didn't bet)
Seat 6: lucky13re folded before Flop (didn't bet)



PokerStars Zoom Hand #210170217770:  Hold'em No Limit (€0.01/€0.02) - 2020/03/15 19:36:52 CET [2020/03/15 14:36:52 ET]
Table 'Arneb' 6-max Seat #1 is the button
Seat 1: MDKristian (€1.85 in chips)
Seat 2: Marlock10 (€1 in chips)
Seat 3: Patrondixx (€2.17 in chips)
Seat 4: Luckers712 (€4.89 in chips)
Seat 5: bilboubou78 (€3.88 in chips)
Seat 6: SonsOfFun (€2.33 in chips)
Marlock10: posts small blind €0.01
Patrondixx: posts big blind €0.02
*** HOLE CARDS ***
Dealt to Luckers712 [8h Jd]
Luckers712: folds
bilboubou78: folds
SonsOfFun: raises €0.03 to €0.05
MDKristian: folds
Marlock10: folds
Patrondixx: calls €0.03
*** FLOP *** [8s Jh 3s]
Patrondixx: bets €0.02
SonsOfFun: raises €0.11 to €0.13
Patrondixx: raises €0.11 to €0.24
SonsOfFun: raises €2.04 to €2.28 and is all-in
Patrondixx: calls €1.88 and is all-in
Uncalled bet (€0.16) returned to SonsOfFun
*** TURN *** [8s Jh 3s] [2s]
*** RIVER *** [8s Jh 3s 2s] [6h]
*** SHOW DOWN ***
Patrondixx: shows [As Qs] (a flush, Ace high)
SonsOfFun: shows [Qc Qd] (a pair of Queens)
Patrondixx collected €4.13 from pot
*** SUMMARY ***
Total pot €4.35 | Rake €0.22
Board [8s Jh 3s 2s 6h]
Seat 1: MDKristian (button) folded before Flop (didn't bet)
Seat 2: Marlock10 (small blind) folded before Flop
Seat 3: Patrondixx (big blind) showed [As Qs] and won (€4.13) with a flush, Ace high
Seat 4: Luckers712 folded before Flop (didn't bet)
Seat 5: bilboubou78 folded before Flop (didn't bet)
Seat 6: SonsOfFun showed [Qc Qd] and lost with a pair of Queens



PokerStars Zoom Hand #210170240289:  Hold'em No Limit (€0.01/€0.02) - 2020/03/15 19:37:16 CET [2020/03/15 14:37:16 ET]
Table 'Arneb' 6-max Seat #1 is the button
Seat 1: choro244 (€2.05 in chips)
Seat 2: amotinado85 (€2.64 in chips)
Seat 3: lusto09 (€4.03 in chips)
Seat 4: mesko19 (€2 in chips)
Seat 5: NanoLMP (€2.32 in chips)
Seat 6: Luckers712 (€4.91 in chips)
amotinado85: posts small blind €0.01
lusto09: posts big blind €0.02
*** HOLE CARDS ***
Dealt to Luckers712 [9s Td]
mesko19: raises €0.04 to €0.06
NanoLMP: folds
Luckers712: folds
choro244: folds
amotinado85: folds
lusto09: folds
Uncalled bet (€0.04) returned to mesko19
mesko19 collected €0.05 from pot
mesko19: doesn't show hand
*** SUMMARY ***
Total pot €0.05 | Rake €0
Seat 1: choro244 (button) folded before Flop (didn't bet)
Seat 2: amotinado85 (small blind) folded before Flop
Seat 3: lusto09 (big blind) folded before Flop
Seat 4: mesko19 collected (€0.05)
Seat 5: NanoLMP folded before Flop (didn't bet)
Seat 6: Luckers712 folded before Flop (didn't bet)



PokerStars Zoom Hand #210170249909:  Hold'em No Limit (€0.01/€0.02) - 2020/03/15 19:37:26 CET [2020/03/15 14:37:26 ET]
Table 'Arneb' 6-max Seat #1 is the button
Seat 1: Luckers712 (€4.89 in chips)
Seat 2: trakson (€2.15 in chips)
Seat 3: lusto09 (€4.41 in chips)
Seat 4: agus166 (€2.07 in chips)
Seat 5: Torcador (€1.49 in chips)
Seat 6: MDKristian (€1.85 in chips)
trakson: posts small blind €0.01
lusto09: posts big blind €0.02
*** HOLE CARDS ***
Dealt to Luckers712 [Kh 8c]
agus166: raises €0.04 to €0.06
Torcador: folds
MDKristian: folds
Luckers712: folds
trakson: folds
lusto09: folds
Uncalled bet (€0.04) returned to agus166
agus166 collected €0.05 from pot
agus166: doesn't show hand
*** SUMMARY ***
Total pot €0.05 | Rake €0
Seat 1: Luckers712 (button) folded before Flop (didn't bet)
Seat 2: trakson (small blind) folded before Flop
Seat 3: lusto09 (big blind) folded before Flop
Seat 4: agus166 collected (€0.05)
Seat 5: Torcador folded before Flop (didn't bet)
Seat 6: MDKristian folded before Flop (didn't bet)



PokerStars Zoom Hand #210170245045:  Hold'em No Limit (€0.01/€0.02) - 2020/03/15 19:37:21 CET [2020/03/15 14:37:21 ET]
Table 'Arneb' 6-max Seat #1 is the button
Seat 1: pichon1000 (€0.92 in chips)
Seat 2: Kayfidze (€2 in chips)
Seat 3: Luckers712 (€4.91 in chips)
Seat 4: ricmp (€5.19 in chips)
Seat 5: cañon000 (€2.59 in chips)
Seat 6: clapo44980 (€1.78 in chips)
Kayfidze: posts small blind €0.01
Luckers712: posts big blind €0.02
*** HOLE CARDS ***
Dealt to Luckers712 [9c 2c]
ricmp: raises €0.04 to €0.06
cañon000: calls €0.06
clapo44980: folds
pichon1000: folds
Kayfidze: folds
Luckers712: folds
*** FLOP *** [Qd 9h 8d]
ricmp: checks
cañon000: checks
*** TURN *** [Qd 9h 8d] [Ah]
ricmp: bets €0.09
cañon000: calls €0.09
*** RIVER *** [Qd 9h 8d Ah] [Js]
ricmp: checks
cañon000: checks
*** SHOW DOWN ***
ricmp: shows [Ac Ad] (three of a kind, Aces)
cañon000: mucks hand
ricmp collected €0.31 from pot
*** SUMMARY ***
Total pot €0.33 | Rake €0.02
Board [Qd 9h 8d Ah Js]
Seat 1: pichon1000 (button) folded before Flop (didn't bet)
Seat 2: Kayfidze (small blind) folded before Flop
Seat 3: Luckers712 (big blind) folded before Flop
Seat 4: ricmp showed [Ac Ad] and won (€0.31) with three of a kind, Aces
Seat 5: cañon000 mucked [6h 8h]
Seat 6: clapo44980 folded before Flop (didn't bet)



PokerStars Zoom Hand #210170255405:  Hold'em No Limit (€0.01/€0.02) - 2020/03/15 19:37:32 CET [2020/03/15 14:37:32 ET]
Table 'Arneb' 6-max Seat #1 is the button
Seat 1: Romanshev (€2.42 in chips)
Seat 2: Luckers712 (€4.89 in chips)
Seat 3: Orisso30 (€2.02 in chips)
Seat 4: petitgold (€2.93 in chips)
Seat 5: slaton (€2 in chips)
Seat 6: raptureman1 (€2.41 in chips)
Luckers712: posts small blind €0.01
Orisso30: posts big blind €0.02
*** HOLE CARDS ***
Dealt to Luckers712 [Ah Kd]
petitgold: folds
slaton: folds
raptureman1: folds
Romanshev: raises €0.05 to €0.07
Luckers712: raises €0.19 to €0.26
Orisso30: folds
Romanshev: calls €0.19
*** FLOP *** [7d Th 5c]
Luckers712: checks
Romanshev: checks
*** TURN *** [7d Th 5c] [As]
Luckers712: bets €0.20
Romanshev: calls €0.20
*** RIVER *** [7d Th 5c As] [6c]
Luckers712: bets €0.60
Romanshev: folds
Uncalled bet (€0.60) returned to Luckers712
Luckers712 collected €0.89 from pot
Luckers712: doesn't show hand
*** SUMMARY ***
Total pot €0.94 | Rake €0.05
Board [7d Th 5c As 6c]
Seat 1: Romanshev (button) folded on the River
Seat 2: Luckers712 (small blind) collected (€0.89)
Seat 3: Orisso30 (big blind) folded before Flop
Seat 4: petitgold folded before Flop (didn't bet)
Seat 5: slaton folded before Flop (didn't bet)
Seat 6: raptureman1 folded before Flop (didn't bet)



PokerStars Zoom Hand #210170349445:  Hold'em No Limit (€0.01/€0.02) - 2020/03/15 19:39:11 CET [2020/03/15 14:39:11 ET]
Table 'Arneb' 6-max Seat #1 is the button
Seat 1: campanilla06 (€2.41 in chips)
Seat 2: Franç@ (€9.57 in chips)
Seat 3: manusilva401 (€2.10 in chips)
Seat 4: petitgold (€2 in chips)
Seat 5: Luckers712 (€5.32 in chips)
Seat 6: lucky13re (€2 in chips)
Franç@: posts small blind €0.01
manusilva401: posts big blind €0.02
*** HOLE CARDS ***
Dealt to Luckers712 [4d Qc]
petitgold: raises €0.03 to €0.05
Luckers712: folds
lucky13re: folds
campanilla06: folds
Franç@: folds
manusilva401: folds
Uncalled bet (€0.03) returned to petitgold
petitgold collected €0.05 from pot
petitgold: doesn't show hand
*** SUMMARY ***
Total pot €0.05 | Rake €0
Seat 1: campanilla06 (button) folded before Flop (didn't bet)
Seat 2: Franç@ (small blind) folded before Flop
Seat 3: manusilva401 (big blind) folded before Flop
Seat 4: petitgold collected (€0.05)
Seat 5: Luckers712 folded before Flop (didn't bet)
Seat 6: lucky13re folded before Flop (didn't bet)



PokerStars Zoom Hand #210170353217:  Hold'em No Limit (€0.01/€0.02) - 2020/03/15 19:39:15 CET [2020/03/15 14:39:15 ET]
Table 'Arneb' 6-max Seat #1 is the button
Seat 1: javigarrido8 (€2.34 in chips)
Seat 2: lucky13re (€2 in chips)
Seat 3: pabmesa (€1.57 in chips)
Seat 4: Luckers712 (€5.32 in chips)
Seat 5: Franç@ (€9.56 in chips)
Seat 6: choro244 (€2 in chips)
lucky13re: posts small blind €0.01
pabmesa: posts big blind €0.02
*** HOLE CARDS ***
Dealt to Luckers712 [5d Ad]
Luckers712: raises €0.03 to €0.05
Franç@: folds
choro244: folds
javigarrido8: folds
lucky13re: raises €0.13 to €0.18
pabmesa: folds
Luckers712: calls €0.13
*** FLOP *** [2d Ts 8c]
lucky13re: bets €0.24
Luckers712: folds
Uncalled bet (€0.24) returned to lucky13re
lucky13re collected €0.36 from pot
lucky13re: doesn't show hand
*** SUMMARY ***
Total pot €0.38 | Rake €0.02
Board [2d Ts 8c]
Seat 1: javigarrido8 (button) folded before Flop (didn't bet)
Seat 2: lucky13re (small blind) collected (€0.36)
Seat 3: pabmesa (big blind) folded before Flop
Seat 4: Luckers712 folded on the Flop
Seat 5: Franç@ folded before Flop (didn't bet)
Seat 6: choro244 folded before Flop (didn't bet)



PokerStars Zoom Hand #210170392661:  Hold'em No Limit (€0.01/€0.02) - 2020/03/15 19:39:57 CET [2020/03/15 14:39:57 ET]
Table 'Arneb' 6-max Seat #1 is the button
Seat 1: w.sherban (€2.27 in chips)
Seat 2: raptureman1 (€2.05 in chips)
Seat 3: Orisso30 (€2.62 in chips)
Seat 4: TheKing11597 (€2.24 in chips)
Seat 5: Sergirb (€2 in chips)
Seat 6: Luckers712 (€5.14 in chips)
raptureman1: posts small blind €0.01
Orisso30: posts big blind €0.02
*** HOLE CARDS ***
Dealt to Luckers712 [4d Kd]
TheKing11597: folds
Sergirb: folds
Luckers712: folds
w.sherban: folds
raptureman1: folds
Uncalled bet (€0.01) returned to Orisso30
Orisso30 collected €0.02 from pot
Orisso30: doesn't show hand
*** SUMMARY ***
Total pot €0.02 | Rake €0
Seat 1: w.sherban (button) folded before Flop (didn't bet)
Seat 2: raptureman1 (small blind) folded before Flop
Seat 3: Orisso30 (big blind) collected (€0.02)
Seat 4: TheKing11597 folded before Flop (didn't bet)
Seat 5: Sergirb folded before Flop (didn't bet)
Seat 6: Luckers712 folded before Flop (didn't bet)



PokerStars Zoom Hand #210170401028:  Hold'em No Limit (€0.01/€0.02) - 2020/03/15 19:40:06 CET [2020/03/15 14:40:06 ET]
Table 'Arneb' 6-max Seat #1 is the button
Seat 1: perolete66 (€4.78 in chips)
Seat 2: pcea74 (€3.65 in chips)
Seat 3: amotinado85 (€2.86 in chips)
Seat 4: aportiquevoy (€2.26 in chips)
Seat 5: Luckers712 (€5.14 in chips)
Seat 6: raptureman1 (€2.05 in chips)
pcea74: posts small blind €0.01
amotinado85: posts big blind €0.02
*** HOLE CARDS ***
Dealt to Luckers712 [2d Qh]
aportiquevoy: folds
Luckers712: folds
raptureman1: folds
perolete66: raises €0.03 to €0.05
pcea74: folds
amotinado85: raises €0.15 to €0.20
perolete66: folds
Uncalled bet (€0.15) returned to amotinado85
amotinado85 collected €0.11 from pot
amotinado85: doesn't show hand
*** SUMMARY ***
Total pot €0.11 | Rake €0
Seat 1: perolete66 (button) folded before Flop
Seat 2: pcea74 (small blind) folded before Flop
Seat 3: amotinado85 (big blind) collected (€0.11)
Seat 4: aportiquevoy folded before Flop (didn't bet)
Seat 5: Luckers712 folded before Flop (didn't bet)
Seat 6: raptureman1 folded before Flop (didn't bet)



PokerStars Zoom Hand #210170410369:  Hold'em No Limit (€0.01/€0.02) - 2020/03/15 19:40:16 CET [2020/03/15 14:40:16 ET]
Table 'Arneb' 6-max Seat #1 is the button
Seat 1: pcea74 (€3.64 in chips)
Seat 2: raptureman1 (€2.30 in chips)
Seat 3: Luckers712 (€5.14 in chips)
Seat 4: P77100 (€1.04 in chips)
Seat 5: Aria71321 (€0.96 in chips)
Seat 6: chiwas12 (€2.13 in chips)
raptureman1: posts small blind €0.01
Luckers712: posts big blind €0.02
*** HOLE CARDS ***
Dealt to Luckers712 [7s 2s]
P77100: folds
Aria71321: raises €0.03 to €0.05
chiwas12: folds
pcea74: folds
raptureman1: folds
Luckers712: folds
Uncalled bet (€0.03) returned to Aria71321
Aria71321 collected €0.05 from pot
Aria71321: doesn't show hand
*** SUMMARY ***
Total pot €0.05 | Rake €0
Seat 1: pcea74 (button) folded before Flop (didn't bet)
Seat 2: raptureman1 (small blind) folded before Flop
Seat 3: Luckers712 (big blind) folded before Flop
Seat 4: P77100 folded before Flop (didn't bet)
Seat 5: Aria71321 collected (€0.05)
Seat 6: chiwas12 folded before Flop (didn't bet)



PokerStars Zoom Hand #210170405748:  Hold'em No Limit (€0.01/€0.02) - 2020/03/15 19:40:11 CET [2020/03/15 14:40:11 ET]
Table 'Arneb' 6-max Seat #1 is the button
Seat 1: Luckers712 (€5.14 in chips)
Seat 2: Veesile (€2.46 in chips)
Seat 3: rdvo16 (€1 in chips)
Seat 4: bandittours (€2.25 in chips)
Seat 5: L.I.Riemann (€2.06 in chips)
Seat 6: Vitorhcsousa (€2.84 in chips)
Veesile: posts small blind €0.01
rdvo16: posts big blind €0.02
*** HOLE CARDS ***
Dealt to Luckers712 [4h Qs]
bandittours: folds
L.I.Riemann: folds
Vitorhcsousa: folds
Luckers712: folds
Veesile: raises €0.16 to €0.18
rdvo16: raises €0.82 to €1 and is all-in
Veesile: calls €0.82
*** FLOP *** [3d Th 7c]
*** TURN *** [3d Th 7c] [8s]
*** RIVER *** [3d Th 7c 8s] [As]
*** SHOW DOWN ***
Veesile: shows [Js Jh] (a pair of Jacks)
rdvo16: shows [Ac 2c] (a pair of Aces)
rdvo16 collected €1.90 from pot
*** SUMMARY ***
Total pot €2 | Rake €0.10
Board [3d Th 7c 8s As]
Seat 1: Luckers712 (button) folded before Flop (didn't bet)
Seat 2: Veesile (small blind) showed [Js Jh] and lost with a pair of Jacks
Seat 3: rdvo16 (big blind) showed [Ac 2c] and won (€1.90) with a pair of Aces
Seat 4: bandittours folded before Flop (didn't bet)
Seat 5: L.I.Riemann folded before Flop (didn't bet)
Seat 6: Vitorhcsousa folded before Flop (didn't bet)



PokerStars Zoom Hand #210170419866:  Hold'em No Limit (€0.01/€0.02) - 2020/03/15 19:40:26 CET [2020/03/15 14:40:26 ET]
Table 'Arneb' 6-max Seat #1 is the button
Seat 1: choro244 (€2 in chips)
Seat 2: Luckers712 (€5.12 in chips)
Seat 3: MaurusT (€2.68 in chips)
Seat 4: anveca34 (€1.80 in chips)
Seat 5: perolete66 (€4.73 in chips)
Seat 6: M5dias (€3.40 in chips)
Luckers712: posts small blind €0.01
MaurusT: posts big blind €0.02
*** HOLE CARDS ***
Dealt to Luckers712 [Th Ah]
anveca34: raises €0.08 to €0.10
perolete66: folds
M5dias: folds
choro244: folds
Luckers712: raises €0.10 to €0.20
MaurusT: folds
anveca34: calls €0.10
*** FLOP *** [3s Kc 7s]
Luckers712: checks
anveca34: bets €0.40
Luckers712: folds
Uncalled bet (€0.40) returned to anveca34
anveca34 collected €0.40 from pot
anveca34: doesn't show hand
*** SUMMARY ***
Total pot €0.42 | Rake €0.02
Board [3s Kc 7s]
Seat 1: choro244 (button) folded before Flop (didn't bet)
Seat 2: Luckers712 (small blind) folded on the Flop
Seat 3: MaurusT (big blind) folded before Flop
Seat 4: anveca34 collected (€0.40)
Seat 5: perolete66 folded before Flop (didn't bet)
Seat 6: M5dias folded before Flop (didn't bet)



PokerStars Zoom Hand #210170453849:  Hold'em No Limit (€0.01/€0.02) - 2020/03/15 19:41:02 CET [2020/03/15 14:41:02 ET]
Table 'Arneb' 6-max Seat #1 is the button
Seat 1: Veesile (€2 in chips)
Seat 2: cyberpyb59 (€1.96 in chips)
Seat 3: MaurusT (€2.06 in chips)
Seat 4: Luckers712 (€4.92 in chips)
Seat 5: Lbrt911 (€1.31 in chips)
Seat 6: bilboubou78 (€7.22 in chips)
cyberpyb59: posts small blind €0.01
MaurusT: posts big blind €0.02
*** HOLE CARDS ***
Dealt to Luckers712 [3d As]
Luckers712: folds
Lbrt911: folds
bilboubou78: raises €0.04 to €0.06
Veesile: folds
cyberpyb59: calls €0.05
MaurusT: calls €0.04
*** FLOP *** [6c 8c 9h]
cyberpyb59: checks
MaurusT: checks
bilboubou78: bets €0.10
cyberpyb59: raises €0.37 to €0.47
MaurusT: folds
bilboubou78: folds
Uncalled bet (€0.37) returned to cyberpyb59
cyberpyb59 collected €0.36 from pot
cyberpyb59: doesn't show hand
*** SUMMARY ***
Total pot €0.38 | Rake €0.02
Board [6c 8c 9h]
Seat 1: Veesile (button) folded before Flop (didn't bet)
Seat 2: cyberpyb59 (small blind) collected (€0.36)
Seat 3: MaurusT (big blind) folded on the Flop
Seat 4: Luckers712 folded before Flop (didn't bet)
Seat 5: Lbrt911 folded before Flop (didn't bet)
Seat 6: bilboubou78 folded on the Flop



PokerStars Zoom Hand #210170457602:  Hold'em No Limit (€0.01/€0.02) - 2020/03/15 19:41:06 CET [2020/03/15 14:41:06 ET]
Table 'Arneb' 6-max Seat #1 is the button
Seat 1: LuisMatos27 (€2.01 in chips)
Seat 2: petitgold (€2.63 in chips)
Seat 3: bilboubou78 (€4.66 in chips)
Seat 4: Latutor13 (€0.53 in chips)
Seat 5: Orisso30 (€2.55 in chips)
Seat 6: Luckers712 (€4.92 in chips)
petitgold: posts small blind €0.01
bilboubou78: posts big blind €0.02
*** HOLE CARDS ***
Dealt to Luckers712 [Jc Kd]
Latutor13: raises €0.02 to €0.04
Orisso30: folds
Luckers712: calls €0.04
LuisMatos27: folds
petitgold: folds
bilboubou78: calls €0.02
*** FLOP *** [2d Jd 5s]
bilboubou78: checks
Latutor13: bets €0.08
Luckers712: calls €0.08
bilboubou78: folds
*** TURN *** [2d Jd 5s] [7c]
Latutor13: bets €0.14
Luckers712: raises €4.62 to €4.76
Latutor13: calls €0.27 and is all-in
Uncalled bet (€4.35) returned to Luckers712
*** RIVER *** [2d Jd 5s 7c] [6d]
*** SHOW DOWN ***
Latutor13: shows [Js Qc] (a pair of Jacks)
Luckers712: shows [Jc Kd] (a pair of Jacks - King kicker)
Luckers712 collected €1.05 from pot
*** SUMMARY ***
Total pot €1.11 | Rake €0.06
Board [2d Jd 5s 7c 6d]
Seat 1: LuisMatos27 (button) folded before Flop (didn't bet)
Seat 2: petitgold (small blind) folded before Flop
Seat 3: bilboubou78 (big blind) folded on the Flop
Seat 4: Latutor13 showed [Js Qc] and lost with a pair of Jacks
Seat 5: Orisso30 folded before Flop (didn't bet)
Seat 6: Luckers712 showed [Jc Kd] and won (€1.05) with a pair of Jacks



PokerStars Zoom Hand #210170530243:  Hold'em No Limit (€0.01/€0.02) - 2020/03/15 19:42:23 CET [2020/03/15 14:42:23 ET]
Table 'Arneb' 6-max Seat #1 is the button
Seat 1: louanmelya (€6.13 in chips)
Seat 2: ivan_ojuelo (€1.54 in chips)
Seat 3: Aleksifr (€2.02 in chips)
Seat 4: Dark_make632 (€2.03 in chips)
Seat 5: Luckers712 (€5.44 in chips)
Seat 6: 14marcelo14 (€1.28 in chips)
ivan_ojuelo: posts small blind €0.01
Aleksifr: posts big blind €0.02
*** HOLE CARDS ***
Dealt to Luckers712 [6s 3c]
Dark_make632: folds
Luckers712: folds
14marcelo14: raises €0.04 to €0.06
louanmelya: raises €0.15 to €0.21
ivan_ojuelo: folds
Aleksifr: folds
14marcelo14: calls €0.15
*** FLOP *** [Kh 9s 7h]
14marcelo14: checks
louanmelya: bets €0.22
14marcelo14: calls €0.22
*** TURN *** [Kh 9s 7h] [8c]
14marcelo14: checks
louanmelya: checks
*** RIVER *** [Kh 9s 7h 8c] [2c]
14marcelo14: checks
louanmelya: checks
*** SHOW DOWN ***
14marcelo14: shows [Js 9h] (a pair of Nines)
louanmelya: mucks hand
14marcelo14 collected €0.85 from pot
*** SUMMARY ***
Total pot €0.89 | Rake €0.04
Board [Kh 9s 7h 8c 2c]
Seat 1: louanmelya (button) mucked [Qc 7c]
Seat 2: ivan_ojuelo (small blind) folded before Flop
Seat 3: Aleksifr (big blind) folded before Flop
Seat 4: Dark_make632 folded before Flop (didn't bet)
Seat 5: Luckers712 folded before Flop (didn't bet)
Seat 6: 14marcelo14 showed [Js 9h] and won (€0.85) with a pair of Nines



PokerStars Zoom Hand #210170545393:  Hold'em No Limit (€0.01/€0.02) - 2020/03/15 19:42:39 CET [2020/03/15 14:42:39 ET]
Table 'Arneb' 6-max Seat #1 is the button
Seat 1: squall2009 (€1.75 in chips)
Seat 2: Jagf0010 (€2.05 in chips)
Seat 3: Luckers712 (€5.43 in chips)
Seat 4: Franç@ (€9.49 in chips)
Seat 5: elijeni1323 (€0.56 in chips)
Seat 6: lucky13re (€2 in chips)
Jagf0010: posts small blind €0.01
Luckers712: posts big blind €0.02
*** HOLE CARDS ***
Dealt to Luckers712 [2h Qh]
Franç@: folds
elijeni1323: folds
lucky13re: folds
squall2009: folds
Jagf0010: folds
Uncalled bet (€0.01) returned to Luckers712
Luckers712 collected €0.02 from pot
Luckers712: doesn't show hand
*** SUMMARY ***
Total pot €0.02 | Rake €0
Seat 1: squall2009 (button) folded before Flop (didn't bet)
Seat 2: Jagf0010 (small blind) folded before Flop
Seat 3: Luckers712 (big blind) collected (€0.02)
Seat 4: Franç@ folded before Flop (didn't bet)
Seat 5: elijeni1323 folded before Flop (didn't bet)
Seat 6: lucky13re folded before Flop (didn't bet)



PokerStars Zoom Hand #210170534917:  Hold'em No Limit (€0.01/€0.02) - 2020/03/15 19:42:28 CET [2020/03/15 14:42:28 ET]
Table 'Arneb' 6-max Seat #1 is the button
Seat 1: LuisMatos27 (€2.70 in chips)
Seat 2: Luckers712 (€5.44 in chips)
Seat 3: DarkLord2104 (€2.17 in chips)
Seat 4: w.sherban (€2.24 in chips)
Seat 5: franfistro97 (€0.96 in chips)
Seat 6: afrodit83 (€1.06 in chips)
Luckers712: posts small blind €0.01
DarkLord2104: posts big blind €0.02
*** HOLE CARDS ***
Dealt to Luckers712 [Qd 4d]
w.sherban: raises €0.04 to €0.06
franfistro97: folds
afrodit83: folds
LuisMatos27: folds
Luckers712: folds
DarkLord2104: calls €0.04
*** FLOP *** [7d 8c 6h]
DarkLord2104: checks
w.sherban: bets €0.04
DarkLord2104: raises €0.16 to €0.20
w.sherban: folds
Uncalled bet (€0.16) returned to DarkLord2104
DarkLord2104 collected €0.20 from pot
DarkLord2104: doesn't show hand
*** SUMMARY ***
Total pot €0.21 | Rake €0.01
Board [7d 8c 6h]
Seat 1: LuisMatos27 (button) folded before Flop (didn't bet)
Seat 2: Luckers712 (small blind) folded before Flop
Seat 3: DarkLord2104 (big blind) collected (€0.20)
Seat 4: w.sherban folded on the Flop
Seat 5: franfistro97 folded before Flop (didn't bet)
Seat 6: afrodit83 folded before Flop (didn't bet)



PokerStars Zoom Hand #210170565261:  Hold'em No Limit (€0.01/€0.02) - 2020/03/15 19:43:00 CET [2020/03/15 14:43:00 ET]
Table 'Arneb' 6-max Seat #1 is the button
Seat 1: Tatxan (€3.55 in chips)
Seat 2: PrOdI11 (€2.01 in chips)
Seat 3: unounoporfavor (€6.03 in chips)
Seat 4: Luckers712 (€5.44 in chips)
Seat 5: Jou"Yonfa$" (€2 in chips)
Seat 6: DNooXLvv (€3.99 in chips)
PrOdI11: posts small blind €0.01
unounoporfavor: posts big blind €0.02
*** HOLE CARDS ***
Dealt to Luckers712 [Th Jc]
Luckers712: folds
Jou"Yonfa$": folds
DNooXLvv: folds
Tatxan: folds
PrOdI11: folds
Uncalled bet (€0.01) returned to unounoporfavor
unounoporfavor collected €0.02 from pot
unounoporfavor: doesn't show hand
*** SUMMARY ***
Total pot €0.02 | Rake €0
Seat 1: Tatxan (button) folded before Flop (didn't bet)
Seat 2: PrOdI11 (small blind) folded before Flop
Seat 3: unounoporfavor (big blind) collected (€0.02)
Seat 4: Luckers712 folded before Flop (didn't bet)
Seat 5: Jou"Yonfa$" folded before Flop (didn't bet)
Seat 6: DNooXLvv folded before Flop (didn't bet)



PokerStars Zoom Hand #210170570953:  Hold'em No Limit (€0.01/€0.02) - 2020/03/15 19:43:06 CET [2020/03/15 14:43:06 ET]
Table 'Arneb' 6-max Seat #1 is the button
Seat 1: SonsOfFun (€2.31 in chips)
Seat 2: agus166 (€2.13 in chips)
Seat 3: Leandro Silva 8 (€1.68 in chips)
Seat 4: Luckers712 (€5.44 in chips)
Seat 5: bilboubou78 (€1.94 in chips)
Seat 6: clapo44980 (€1.65 in chips)
agus166: posts small blind €0.01
Leandro Silva 8: posts big blind €0.02
*** HOLE CARDS ***
Dealt to Luckers712 [6d Kd]
Luckers712: folds
bilboubou78: folds
clapo44980: calls €0.02
SonsOfFun: folds
agus166: folds
Leandro Silva 8: raises €0.02 to €0.04
clapo44980: calls €0.02
*** FLOP *** [3h 4c 3d]
Leandro Silva 8: bets €0.05
clapo44980: calls €0.05
*** TURN *** [3h 4c 3d] [Kh]
Leandro Silva 8: bets €0.09
clapo44980: folds
Uncalled bet (€0.09) returned to Leandro Silva 8
Leandro Silva 8 collected €0.18 from pot
Leandro Silva 8: doesn't show hand
*** SUMMARY ***
Total pot €0.19 | Rake €0.01
Board [3h 4c 3d Kh]
Seat 1: SonsOfFun (button) folded before Flop (didn't bet)
Seat 2: agus166 (small blind) folded before Flop
Seat 3: Leandro Silva 8 (big blind) collected (€0.18)
Seat 4: Luckers712 folded before Flop (didn't bet)
Seat 5: bilboubou78 folded before Flop (didn't bet)
Seat 6: clapo44980 folded on the Turn



PokerStars Zoom Hand #210170556705:  Hold'em No Limit (€0.01/€0.02) - 2020/03/15 19:42:51 CET [2020/03/15 14:42:51 ET]
Table 'Arneb' 6-max Seat #1 is the button
Seat 1: Luckers712 (€5.44 in chips)
Seat 2: bilboubou78 (€6.79 in chips)
Seat 3: TheKing11597 (€2 in chips)
Seat 4: garza2610 (€1.10 in chips)
Seat 5: poirier59 (€0.95 in chips)
Seat 6: DNooXLvv (€6.15 in chips)
bilboubou78: posts small blind €0.01
TheKing11597: posts big blind €0.02
*** HOLE CARDS ***
Dealt to Luckers712 [4c 8h]
garza2610: folds
poirier59: calls €0.02
DNooXLvv: folds
Luckers712: folds
bilboubou78: folds
TheKing11597: checks
*** FLOP *** [5c 2c Qs]
TheKing11597: checks
poirier59: checks
*** TURN *** [5c 2c Qs] [8d]
TheKing11597: checks
poirier59: checks
*** RIVER *** [5c 2c Qs 8d] [2d]
TheKing11597: checks
poirier59: checks
*** SHOW DOWN ***
TheKing11597: shows [Js 9h] (a pair of Deuces)
poirier59: mucks hand
TheKing11597 collected €0.05 from pot
*** SUMMARY ***
Total pot €0.05 | Rake €0
Board [5c 2c Qs 8d 2d]
Seat 1: Luckers712 (button) folded before Flop (didn't bet)
Seat 2: bilboubou78 (small blind) folded before Flop
Seat 3: TheKing11597 (big blind) showed [Js 9h] and won (€0.05) with a pair of Deuces
Seat 4: garza2610 folded before Flop (didn't bet)
Seat 5: poirier59 mucked [9d 4d]
Seat 6: DNooXLvv folded before Flop (didn't bet)



PokerStars Zoom Hand #210170592263:  Hold'em No Limit (€0.01/€0.02) - 2020/03/15 19:43:29 CET [2020/03/15 14:43:29 ET]
Table 'Arneb' 6-max Seat #1 is the button
Seat 1: Luckers712 (€5.42 in chips)
Seat 2: tulcio (€2 in chips)
Seat 3: ERIZOCACHO (€1.45 in chips)
Seat 4: raptureman1 (€2 in chips)
Seat 5: L.I.Riemann (€2.18 in chips)
Seat 6: soulfunk1 (€1.91 in chips)
tulcio: posts small blind €0.01
ERIZOCACHO: posts big blind €0.02
*** HOLE CARDS ***
Dealt to Luckers712 [Kd Qs]
raptureman1: folds
L.I.Riemann: folds
soulfunk1: folds
Luckers712: raises €0.04 to €0.06
tulcio: folds
ERIZOCACHO: folds
Uncalled bet (€0.04) returned to Luckers712
Luckers712 collected €0.05 from pot
Luckers712: doesn't show hand
*** SUMMARY ***
Total pot €0.05 | Rake €0
Seat 1: Luckers712 (button) collected (€0.05)
Seat 2: tulcio (small blind) folded before Flop
Seat 3: ERIZOCACHO (big blind) folded before Flop
Seat 4: raptureman1 folded before Flop (didn't bet)
Seat 5: L.I.Riemann folded before Flop (didn't bet)
Seat 6: soulfunk1 folded before Flop (didn't bet)



PokerStars Zoom Hand #210170588572:  Hold'em No Limit (€0.01/€0.02) - 2020/03/15 19:43:25 CET [2020/03/15 14:43:25 ET]
Table 'Arneb' 6-max Seat #1 is the button
Seat 1: soulfunk1 (€1.91 in chips)
Seat 2: eliasbarr (€1.28 in chips)
Seat 3: aportiquevoy (€1.98 in chips)
Seat 4: xPeskailla (€2.19 in chips)
Seat 5: Luckers712 (€5.42 in chips)
Seat 6: NanoLMP (€2.06 in chips)
eliasbarr: posts small blind €0.01
aportiquevoy: posts big blind €0.02
*** HOLE CARDS ***
Dealt to Luckers712 [9c Ts]
xPeskailla: folds
Luckers712: folds
NanoLMP: folds
soulfunk1: folds
eliasbarr: raises €0.03 to €0.05
aportiquevoy: folds
Uncalled bet (€0.03) returned to eliasbarr
eliasbarr collected €0.04 from pot
eliasbarr: doesn't show hand
*** SUMMARY ***
Total pot €0.04 | Rake €0
Seat 1: soulfunk1 (button) folded before Flop (didn't bet)
Seat 2: eliasbarr (small blind) collected (€0.04)
Seat 3: aportiquevoy (big blind) folded before Flop
Seat 4: xPeskailla folded before Flop (didn't bet)
Seat 5: Luckers712 folded before Flop (didn't bet)
Seat 6: NanoLMP folded before Flop (didn't bet)



PokerStars Zoom Hand #210170560524:  Hold'em No Limit (€0.01/€0.02) - 2020/03/15 19:42:55 CET [2020/03/15 14:42:55 ET]
Table 'Arneb' 6-max Seat #1 is the button
Seat 1: PrOdI11 (€2.01 in chips)
Seat 2: moonkeeer (€1.07 in chips)
Seat 3: NanoLMP (€2.41 in chips)
Seat 4: chalaita (€0.94 in chips)
Seat 5: SonsOfFun (€2.13 in chips)
Seat 6: Luckers712 (€5.44 in chips)
moonkeeer: posts small blind €0.01
NanoLMP: posts big blind €0.02
*** HOLE CARDS ***
Dealt to Luckers712 [Ks 4d]
chalaita: folds
SonsOfFun: folds
Luckers712: folds
PrOdI11: folds
moonkeeer: calls €0.01
NanoLMP: checks
*** FLOP *** [6s 2h 5s]
moonkeeer: checks
NanoLMP: checks
*** TURN *** [6s 2h 5s] [9c]
moonkeeer: checks
NanoLMP: checks
*** RIVER *** [6s 2h 5s 9c] [Qd]
moonkeeer: bets €0.02
NanoLMP: folds
Uncalled bet (€0.02) returned to moonkeeer
moonkeeer collected €0.04 from pot
moonkeeer: doesn't show hand
*** SUMMARY ***
Total pot €0.04 | Rake €0
Board [6s 2h 5s 9c Qd]
Seat 1: PrOdI11 (button) folded before Flop (didn't bet)
Seat 2: moonkeeer (small blind) collected (€0.04)
Seat 3: NanoLMP (big blind) folded on the River
Seat 4: chalaita folded before Flop (didn't bet)
Seat 5: SonsOfFun folded before Flop (didn't bet)
Seat 6: Luckers712 folded before Flop (didn't bet)



PokerStars Zoom Hand #210170577503:  Hold'em No Limit (€0.01/€0.02) - 2020/03/15 19:43:13 CET [2020/03/15 14:43:13 ET]
Table 'Arneb' 6-max Seat #1 is the button
Seat 1: o1o0o1o (€2.18 in chips)
Seat 2: Seron1023 (€3.30 in chips)
Seat 3: Luckers712 (€5.44 in chips)
Seat 4: tulcio (€2.26 in chips)
Seat 5: Bardini_SD (€4.17 in chips)
Seat 6: cocololo91 (€3.35 in chips)
Seron1023: posts small blind €0.01
Luckers712: posts big blind €0.02
*** HOLE CARDS ***
Dealt to Luckers712 [4c 6h]
tulcio: folds
Bardini_SD: raises €0.05 to €0.07
cocololo91: folds
o1o0o1o: folds
Seron1023: folds
Luckers712: folds
Uncalled bet (€0.05) returned to Bardini_SD
Bardini_SD collected €0.05 from pot
Bardini_SD: doesn't show hand
*** SUMMARY ***
Total pot €0.05 | Rake €0
Seat 1: o1o0o1o (button) folded before Flop (didn't bet)
Seat 2: Seron1023 (small blind) folded before Flop
Seat 3: Luckers712 (big blind) folded before Flop
Seat 4: tulcio folded before Flop (didn't bet)
Seat 5: Bardini_SD collected (€0.05)
Seat 6: cocololo91 folded before Flop (didn't bet)



PokerStars Zoom Hand #210170624527:  Hold'em No Limit (€0.01/€0.02) - 2020/03/15 19:44:03 CET [2020/03/15 14:44:03 ET]
Table 'Arneb' 6-max Seat #1 is the button
Seat 1: Luckers712 (€5.44 in chips)
Seat 2: L.I.Riemann (€2.17 in chips)
Seat 3: petitgold (€2.43 in chips)
Seat 4: eliasbarr (€1.30 in chips)
Seat 5: Ballagarey (€2.23 in chips)
Seat 6: OA83AO (€6.01 in chips)
L.I.Riemann: posts small blind €0.01
petitgold: posts big blind €0.02
*** HOLE CARDS ***
Dealt to Luckers712 [9h 8h]
eliasbarr: folds
Ballagarey: folds
OA83AO: folds
Luckers712: raises €0.04 to €0.06
L.I.Riemann: folds
petitgold: folds
Uncalled bet (€0.04) returned to Luckers712
Luckers712 collected €0.05 from pot
Luckers712: doesn't show hand
*** SUMMARY ***
Total pot €0.05 | Rake €0
Seat 1: Luckers712 (button) collected (€0.05)
Seat 2: L.I.Riemann (small blind) folded before Flop
Seat 3: petitgold (big blind) folded before Flop
Seat 4: eliasbarr folded before Flop (didn't bet)
Seat 5: Ballagarey folded before Flop (didn't bet)
Seat 6: OA83AO folded before Flop (didn't bet)



PokerStars Zoom Hand #210170615157:  Hold'em No Limit (€0.01/€0.02) - 2020/03/15 19:43:53 CET [2020/03/15 14:43:53 ET]
Table 'Arneb' 6-max Seat #1 is the button
Seat 1: moonkeeer (€1.09 in chips)
Seat 2: chiwas12 (€11.30 in chips)
Seat 3: Alfcape (€0.90 in chips)
Seat 4: Lbrt911 (€1.10 in chips)
Seat 5: 00Spidy00 (€2 in chips)
Seat 6: Luckers712 (€5.44 in chips)
chiwas12: posts small blind €0.01
Alfcape: posts big blind €0.02
*** HOLE CARDS ***
Dealt to Luckers712 [4d Kd]
Lbrt911: folds
00Spidy00: folds
Luckers712: folds
moonkeeer: calls €0.02
chiwas12: folds
Alfcape: checks
*** FLOP *** [Ts 9d 5h]
Alfcape: checks
moonkeeer: bets €0.04
Alfcape: folds
Uncalled bet (€0.04) returned to moonkeeer
moonkeeer collected €0.05 from pot
moonkeeer: doesn't show hand
*** SUMMARY ***
Total pot €0.05 | Rake €0
Board [Ts 9d 5h]
Seat 1: moonkeeer (button) collected (€0.05)
Seat 2: chiwas12 (small blind) folded before Flop
Seat 3: Alfcape (big blind) folded on the Flop
Seat 4: Lbrt911 folded before Flop (didn't bet)
Seat 5: 00Spidy00 folded before Flop (didn't bet)
Seat 6: Luckers712 folded before Flop (didn't bet)



PokerStars Zoom Hand #210170619755:  Hold'em No Limit (€0.01/€0.02) - 2020/03/15 19:43:58 CET [2020/03/15 14:43:58 ET]
Table 'Arneb' 6-max Seat #1 is the button
Seat 1: P77100 (€0.49 in chips)
Seat 2: jefewiggum33 (€2.65 in chips)
Seat 3: ismasu (€2 in chips)
Seat 4: lusto09 (€2.74 in chips)
Seat 5: Luckers712 (€5.44 in chips)
Seat 6: clapo44980 (€1.57 in chips)
jefewiggum33: posts small blind €0.01
ismasu: posts big blind €0.02
*** HOLE CARDS ***
Dealt to Luckers712 [5c 4h]
lusto09: folds
Luckers712: folds
clapo44980: folds
P77100: raises €0.02 to €0.04
jefewiggum33: folds
ismasu: calls €0.02
*** FLOP *** [Qd 6s 9h]
ismasu: checks
P77100: bets €0.09
ismasu: calls €0.09
*** TURN *** [Qd 6s 9h] [Js]
ismasu: checks
P77100: bets €0.26
ismasu: folds
Uncalled bet (€0.26) returned to P77100
P77100 collected €0.26 from pot
P77100: doesn't show hand
*** SUMMARY ***
Total pot €0.27 | Rake €0.01
Board [Qd 6s 9h Js]
Seat 1: P77100 (button) collected (€0.26)
Seat 2: jefewiggum33 (small blind) folded before Flop
Seat 3: ismasu (big blind) folded on the Turn
Seat 4: lusto09 folded before Flop (didn't bet)
Seat 5: Luckers712 folded before Flop (didn't bet)
Seat 6: clapo44980 folded before Flop (didn't bet)



PokerStars Zoom Hand #210170645160:  Hold'em No Limit (€0.01/€0.02) - 2020/03/15 19:44:25 CET [2020/03/15 14:44:25 ET]
Table 'Arneb' 6-max Seat #1 is the button
Seat 1: FocusBuilder (€1 in chips)
Seat 2: kingdjass972 (€2.53 in chips)
Seat 3: Luckers712 (€5.47 in chips)
Seat 4: ElvasSniper (€4.07 in chips)
Seat 5: Kayfidze (€2 in chips)
Seat 6: Veesile (€2 in chips)
kingdjass972: posts small blind €0.01
Luckers712: posts big blind €0.02
*** HOLE CARDS ***
Dealt to Luckers712 [4h 7h]
ElvasSniper: folds
Kayfidze: folds
Veesile: raises €0.03 to €0.05
FocusBuilder: folds
kingdjass972: folds
Luckers712: raises €0.09 to €0.14
Veesile: raises €1.86 to €2 and is all-in
Luckers712: folds
Uncalled bet (€1.86) returned to Veesile
Veesile collected €0.29 from pot
Veesile: doesn't show hand
*** SUMMARY ***
Total pot €0.29 | Rake €0
Seat 1: FocusBuilder (button) folded before Flop (didn't bet)
Seat 2: kingdjass972 (small blind) folded before Flop
Seat 3: Luckers712 (big blind) folded before Flop
Seat 4: ElvasSniper folded before Flop (didn't bet)
Seat 5: Kayfidze folded before Flop (didn't bet)
Seat 6: Veesile collected (€0.29)



PokerStars Zoom Hand #210170604791:  Hold'em No Limit (€0.01/€0.02) - 2020/03/15 19:43:42 CET [2020/03/15 14:43:42 ET]
Table 'Arneb' 6-max Seat #1 is the button
Seat 1: L.I.Riemann (€2.17 in chips)
Seat 2: Luckers712 (€5.45 in chips)
Seat 3: Facs10 (€2.04 in chips)
Seat 4: freececi (€3.26 in chips)
Seat 5: Orisso30 (€2.15 in chips)
Seat 6: kelloo01 (€11.76 in chips)
Luckers712: posts small blind €0.01
Facs10: posts big blind €0.02
*** HOLE CARDS ***
Dealt to Luckers712 [Qs Jh]
freececi: raises €0.04 to €0.06
Orisso30: folds
kelloo01: folds
L.I.Riemann: folds
Luckers712: folds
Facs10: calls €0.04
*** FLOP *** [4h 4s Qc]
Facs10: checks
freececi: bets €0.06
Facs10: calls €0.06
*** TURN *** [4h 4s Qc] [Ts]
Facs10: checks
freececi: checks
*** RIVER *** [4h 4s Qc Ts] [2h]
Facs10: bets €0.24
freececi: calls €0.24
*** SHOW DOWN ***
Facs10: shows [Ad 8d] (a pair of Fours)
freececi: shows [Tc Ac] (two pair, Tens and Fours)
freececi collected €0.69 from pot
*** SUMMARY ***
Total pot €0.73 | Rake €0.04
Board [4h 4s Qc Ts 2h]
Seat 1: L.I.Riemann (button) folded before Flop (didn't bet)
Seat 2: Luckers712 (small blind) folded before Flop
Seat 3: Facs10 (big blind) showed [Ad 8d] and lost with a pair of Fours
Seat 4: freececi showed [Tc Ac] and won (€0.69) with two pair, Tens and Fours
Seat 5: Orisso30 folded before Flop (didn't bet)
Seat 6: kelloo01 folded before Flop (didn't bet)



PokerStars Zoom Hand #210170665968:  Hold'em No Limit (€0.01/€0.02) - 2020/03/15 19:44:47 CET [2020/03/15 14:44:47 ET]
Table 'Arneb' 6-max Seat #1 is the button
Seat 1: nandito68 (€2.22 in chips)
Seat 2: Luckers712 (€5.33 in chips)
Seat 3: Dark_make632 (€2.39 in chips)
Seat 4: MaurusT (€2.14 in chips)
Seat 5: HGrenha (€3.82 in chips)
Seat 6: SonsOfFun (€2.50 in chips)
Luckers712: posts small blind €0.01
Dark_make632: posts big blind €0.02
*** HOLE CARDS ***
Dealt to Luckers712 [Ah 5c]
MaurusT: folds
HGrenha: folds
SonsOfFun: folds
nandito68 has timed out while disconnected
nandito68: folds
Luckers712: raises €0.04 to €0.06
Dark_make632: raises €0.12 to €0.18
Luckers712: raises €0.22 to €0.40
Dark_make632: folds
Uncalled bet (€0.22) returned to Luckers712
Luckers712 collected €0.36 from pot
Luckers712: doesn't show hand
*** SUMMARY ***
Total pot €0.36 | Rake €0
Seat 1: nandito68 (button) folded before Flop (didn't bet)
Seat 2: Luckers712 (small blind) collected (€0.36)
Seat 3: Dark_make632 (big blind) folded before Flop
Seat 4: MaurusT folded before Flop (didn't bet)
Seat 5: HGrenha folded before Flop (didn't bet)
Seat 6: SonsOfFun folded before Flop (didn't bet)



PokerStars Zoom Hand #210170723297:  Hold'em No Limit (€0.01/€0.02) - 2020/03/15 19:45:48 CET [2020/03/15 14:45:48 ET]
Table 'Arneb' 6-max Seat #1 is the button
Seat 1: LuisMatos27 (€2.10 in chips)
Seat 2: louanmelya (€7.51 in chips)
Seat 3: tulcio (€2.03 in chips)
Seat 4: agus166 (€2 in chips)
Seat 5: ArkangelGoth (€0.97 in chips)
Seat 6: Luckers712 (€5.51 in chips)
louanmelya: posts small blind €0.01
tulcio: posts big blind €0.02
*** HOLE CARDS ***
Dealt to Luckers712 [Tc 7s]
agus166: folds
ArkangelGoth: folds
Luckers712: folds
LuisMatos27: folds
louanmelya: folds
Uncalled bet (€0.01) returned to tulcio
tulcio collected €0.02 from pot
tulcio: doesn't show hand
*** SUMMARY ***
Total pot €0.02 | Rake €0
Seat 1: LuisMatos27 (button) folded before Flop (didn't bet)
Seat 2: louanmelya (small blind) folded before Flop
Seat 3: tulcio (big blind) collected (€0.02)
Seat 4: agus166 folded before Flop (didn't bet)
Seat 5: ArkangelGoth folded before Flop (didn't bet)
Seat 6: Luckers712 folded before Flop (didn't bet)



PokerStars Zoom Hand #210170730862:  Hold'em No Limit (€0.01/€0.02) - 2020/03/15 19:45:56 CET [2020/03/15 14:45:56 ET]
Table 'Arneb' 6-max Seat #1 is the button
Seat 1: Miltonmoreno (€2.86 in chips)
Seat 2: Rodriwoow (€2.10 in chips)
Seat 3: hitbarr83 (€1.97 in chips)
Seat 4: Luckers712 (€5.51 in chips)
Seat 5: amotinado85 (€2.23 in chips)
Seat 6: bilboubou78 (€4.76 in chips)
Rodriwoow: posts small blind €0.01
hitbarr83: posts big blind €0.02
*** HOLE CARDS ***
Dealt to Luckers712 [9h 8h]
Luckers712: raises €0.04 to €0.06
amotinado85: folds
bilboubou78: folds
Miltonmoreno has timed out while disconnected
Miltonmoreno: folds
Rodriwoow: folds
hitbarr83: folds
Uncalled bet (€0.04) returned to Luckers712
Luckers712 collected €0.05 from pot
Luckers712: doesn't show hand
*** SUMMARY ***
Total pot €0.05 | Rake €0
Seat 1: Miltonmoreno (button) folded before Flop (didn't bet)
Seat 2: Rodriwoow (small blind) folded before Flop
Seat 3: hitbarr83 (big blind) folded before Flop
Seat 4: Luckers712 collected (€0.05)
Seat 5: amotinado85 folded before Flop (didn't bet)
Seat 6: bilboubou78 folded before Flop (didn't bet)



PokerStars Zoom Hand #210170759892:  Hold'em No Limit (€0.01/€0.02) - 2020/03/15 19:46:27 CET [2020/03/15 14:46:27 ET]
Table 'Arneb' 6-max Seat #1 is the button
Seat 1: Luckers712 (€5.54 in chips)
Seat 2: Menorqui (€2.40 in chips)
Seat 3: ERIZOCACHO (€0.62 in chips)
Seat 4: serbot131 (€4.85 in chips)
Seat 5: chiwas12 (€2 in chips)
Seat 6: trakson (€2.05 in chips)
Menorqui: posts small blind €0.01
ERIZOCACHO: posts big blind €0.02
*** HOLE CARDS ***
Dealt to Luckers712 [3c 9h]
serbot131: folds
chiwas12: folds
trakson: folds
Luckers712: folds
Menorqui: folds
Uncalled bet (€0.01) returned to ERIZOCACHO
ERIZOCACHO collected €0.02 from pot
ERIZOCACHO: doesn't show hand
*** SUMMARY ***
Total pot €0.02 | Rake €0
Seat 1: Luckers712 (button) folded before Flop (didn't bet)
Seat 2: Menorqui (small blind) folded before Flop
Seat 3: ERIZOCACHO (big blind) collected (€0.02)
Seat 4: serbot131 folded before Flop (didn't bet)
Seat 5: chiwas12 folded before Flop (didn't bet)
Seat 6: trakson folded before Flop (didn't bet)



PokerStars Zoom Hand #210170763527:  Hold'em No Limit (€0.01/€0.02) - 2020/03/15 19:46:31 CET [2020/03/15 14:46:31 ET]
Table 'Arneb' 6-max Seat #1 is the button
Seat 1: EL PVDRIN0 (€1.96 in chips)
Seat 2: masquisiera (€2.20 in chips)
Seat 3: fullba31 (€1.37 in chips)
Seat 4: raptureman1 (€2 in chips)
Seat 5: Luckers712 (€5.54 in chips)
Seat 6: DNooXLvv (€6.96 in chips)
masquisiera: posts small blind €0.01
fullba31: posts big blind €0.02
*** HOLE CARDS ***
Dealt to Luckers712 [8s 7c]
raptureman1: folds
Luckers712: folds
DNooXLvv: folds
EL PVDRIN0: folds
masquisiera: folds
Uncalled bet (€0.01) returned to fullba31
fullba31 collected €0.02 from pot
fullba31: doesn't show hand
*** SUMMARY ***
Total pot €0.02 | Rake €0
Seat 1: EL PVDRIN0 (button) folded before Flop (didn't bet)
Seat 2: masquisiera (small blind) folded before Flop
Seat 3: fullba31 (big blind) collected (€0.02)
Seat 4: raptureman1 folded before Flop (didn't bet)
Seat 5: Luckers712 folded before Flop (didn't bet)
Seat 6: DNooXLvv folded before Flop (didn't bet)



PokerStars Zoom Hand #210170727016:  Hold'em No Limit (€0.01/€0.02) - 2020/03/15 19:45:52 CET [2020/03/15 14:45:52 ET]
Table 'Arneb' 6-max Seat #1 is the button
Seat 1: ChaCha120488 (€0.31 in chips)
Seat 2: ceronalemany (€1.69 in chips)
Seat 3: manuelsg89 (€2 in chips)
Seat 4: Luckers712 (€5.51 in chips)
Seat 5: Kayfidze (€2.68 in chips)
Seat 6: campanilla06 (€2.68 in chips)
ceronalemany: posts small blind €0.01
manuelsg89: posts big blind €0.02
*** HOLE CARDS ***
Dealt to Luckers712 [Kh 7c]
Luckers712: folds
Kayfidze: folds
campanilla06: folds
ChaCha120488: raises €0.04 to €0.06
ceronalemany: calls €0.05
manuelsg89: raises €0.20 to €0.26
ChaCha120488: raises €0.05 to €0.31 and is all-in
ceronalemany: calls €0.25
manuelsg89: calls €0.05
*** FLOP *** [8c Ad Td]
ceronalemany: checks
manuelsg89: checks
*** TURN *** [8c Ad Td] [Ks]
ceronalemany: checks
manuelsg89: checks
*** RIVER *** [8c Ad Td Ks] [Ts]
ceronalemany: checks
manuelsg89: checks
*** SHOW DOWN ***
ceronalemany: shows [Jh 8s] (two pair, Tens and Eights)
manuelsg89: mucks hand
ChaCha120488: shows [9d 9c] (two pair, Tens and Nines)
ChaCha120488 collected €0.88 from pot
*** SUMMARY ***
Total pot €0.93 | Rake €0.05
Board [8c Ad Td Ks Ts]
Seat 1: ChaCha120488 (button) showed [9d 9c] and won (€0.88) with two pair, Tens and Nines
Seat 2: ceronalemany (small blind) showed [Jh 8s] and lost with two pair, Tens and Eights
Seat 3: manuelsg89 (big blind) mucked [6s 6d]
Seat 4: Luckers712 folded before Flop (didn't bet)
Seat 5: Kayfidze folded before Flop (didn't bet)
Seat 6: campanilla06 folded before Flop (didn't bet)



PokerStars Zoom Hand #210170791089:  Hold'em No Limit (€0.01/€0.02) - 2020/03/15 19:46:50 CET [2020/03/15 14:46:50 ET]
Table 'Arneb' 6-max Seat #1 is the button
Seat 1: squall2009 (€0.77 in chips)
Seat 2: OA83AO (€5.98 in chips)
Seat 3: lunasa (€3.87 in chips)
Seat 4: Veesile (€3.83 in chips)
Seat 5: Luckers712 (€5.52 in chips)
Seat 6: javigarrido8 (€1.78 in chips)
OA83AO: posts small blind €0.01
lunasa: posts big blind €0.02
*** HOLE CARDS ***
Dealt to Luckers712 [Ts 4d]
Veesile: folds
Luckers712: folds
javigarrido8: raises €0.04 to €0.06
squall2009: folds
OA83AO: folds
lunasa: folds
Uncalled bet (€0.04) returned to javigarrido8
javigarrido8 collected €0.05 from pot
javigarrido8: doesn't show hand
*** SUMMARY ***
Total pot €0.05 | Rake €0
Seat 1: squall2009 (button) folded before Flop (didn't bet)
Seat 2: OA83AO (small blind) folded before Flop
Seat 3: lunasa (big blind) folded before Flop
Seat 4: Veesile folded before Flop (didn't bet)
Seat 5: Luckers712 folded before Flop (didn't bet)
Seat 6: javigarrido8 collected (€0.05)



PokerStars Zoom Hand #210170767363:  Hold'em No Limit (€0.01/€0.02) - 2020/03/15 19:46:35 CET [2020/03/15 14:46:35 ET]
Table 'Arneb' 6-max Seat #1 is the button
Seat 1: unounoporfavor (€2 in chips)
Seat 2: Carma312 (€1.21 in chips)
Seat 3: Luckers712 (€5.54 in chips)
Seat 4: aportiquevoy (€1.77 in chips)
Seat 5: Veesile (€3.83 in chips)
Seat 6: agus166 (€2 in chips)
Carma312: posts small blind €0.01
Luckers712: posts big blind €0.02
*** HOLE CARDS ***
Dealt to Luckers712 [9d 7h]
aportiquevoy: folds
Veesile: folds
agus166: folds
unounoporfavor: raises €0.02 to €0.04
Carma312: raises €0.06 to €0.10
Luckers712: folds
unounoporfavor: calls €0.06
*** FLOP *** [Qs Tc 8c]
Carma312: checks
unounoporfavor: bets €0.08
Carma312: folds
Uncalled bet (€0.08) returned to unounoporfavor
unounoporfavor collected €0.21 from pot
unounoporfavor: doesn't show hand
*** SUMMARY ***
Total pot €0.22 | Rake €0.01
Board [Qs Tc 8c]
Seat 1: unounoporfavor (button) collected (€0.21)
Seat 2: Carma312 (small blind) folded on the Flop
Seat 3: Luckers712 (big blind) folded before Flop
Seat 4: aportiquevoy folded before Flop (didn't bet)
Seat 5: Veesile folded before Flop (didn't bet)
Seat 6: agus166 folded before Flop (didn't bet)



PokerStars Zoom Hand #210170800460:  Hold'em No Limit (€0.01/€0.02) - 2020/03/15 19:47:00 CET [2020/03/15 14:47:00 ET]
Table 'Arneb' 6-max Seat #1 is the button
Seat 1: SaiyanSergio (€2.63 in chips)
Seat 2: MMMJLMALM (€1 in chips)
Seat 3: Veesile (€3.83 in chips)
Seat 4: HGrenha (€3.62 in chips)
Seat 5: manuelsg89 (€2.04 in chips)
Seat 6: Luckers712 (€5.51 in chips)
MMMJLMALM: posts small blind €0.01
Veesile: posts big blind €0.02
*** HOLE CARDS ***
Dealt to Luckers712 [5s Jc]
HGrenha: folds
manuelsg89: folds
Luckers712: folds
SaiyanSergio: folds
MMMJLMALM: folds
Uncalled bet (€0.01) returned to Veesile
Veesile collected €0.02 from pot
Veesile: doesn't show hand
*** SUMMARY ***
Total pot €0.02 | Rake €0
Seat 1: SaiyanSergio (button) folded before Flop (didn't bet)
Seat 2: MMMJLMALM (small blind) folded before Flop
Seat 3: Veesile (big blind) collected (€0.02)
Seat 4: HGrenha folded before Flop (didn't bet)
Seat 5: manuelsg89 folded before Flop (didn't bet)
Seat 6: Luckers712 folded before Flop (didn't bet)



PokerStars Zoom Hand #210170795728:  Hold'em No Limit (€0.01/€0.02) - 2020/03/15 19:46:55 CET [2020/03/15 14:46:55 ET]
Table 'Arneb' 6-max Seat #1 is the button
Seat 1: tatanekiki (€3.30 in chips)
Seat 2: Luckers712 (€5.52 in chips)
Seat 3: shegotcakes (€2.38 in chips)
Seat 4: bandittours (€2.23 in chips)
Seat 5: NanoLMP (€2.21 in chips)
Seat 6: OA83AO (€5.97 in chips)
Luckers712: posts small blind €0.01
shegotcakes: posts big blind €0.02
*** HOLE CARDS ***
Dealt to Luckers712 [Tc 2d]
bandittours: folds
NanoLMP: raises €0.04 to €0.06
OA83AO: folds
tatanekiki: calls €0.06
Luckers712: folds
shegotcakes: folds
*** FLOP *** [4s 8s Qh]
NanoLMP: bets €0.04
tatanekiki: folds
Uncalled bet (€0.04) returned to NanoLMP
NanoLMP collected €0.14 from pot
NanoLMP: doesn't show hand
*** SUMMARY ***
Total pot €0.15 | Rake €0.01
Board [4s 8s Qh]
Seat 1: tatanekiki (button) folded on the Flop
Seat 2: Luckers712 (small blind) folded before Flop
Seat 3: shegotcakes (big blind) folded before Flop
Seat 4: bandittours folded before Flop (didn't bet)
Seat 5: NanoLMP collected (€0.14)
Seat 6: OA83AO folded before Flop (didn't bet)



PokerStars Zoom Hand #210170810882:  Hold'em No Limit (€0.01/€0.02) - 2020/03/15 19:47:11 CET [2020/03/15 14:47:11 ET]
Table 'Arneb' 6-max Seat #1 is the button
Seat 1: Luckers712 (€5.51 in chips)
Seat 2: masquisiera (€2.15 in chips)
Seat 3: portospouto (€1.29 in chips)
Seat 4: marsatack28 (€3.86 in chips)
Seat 5: Anme41 (€2.19 in chips)
Seat 6: xateadoo (€2.19 in chips)
masquisiera: posts small blind €0.01
portospouto: posts big blind €0.02
*** HOLE CARDS ***
Dealt to Luckers712 [Kd Ks]
marsatack28: raises €0.04 to €0.06
Anme41: folds
xateadoo: folds
Luckers712: raises €0.15 to €0.21
masquisiera: folds
portospouto: folds
marsatack28: calls €0.15
*** FLOP *** [Ac Td Kh]
marsatack28: checks
Luckers712: bets €0.21
marsatack28: calls €0.21
*** TURN *** [Ac Td Kh] [8h]
marsatack28: checks
Luckers712: bets €0.70
marsatack28: folds
Uncalled bet (€0.70) returned to Luckers712
Luckers712 collected €0.83 from pot
Luckers712: doesn't show hand
*** SUMMARY ***
Total pot €0.87 | Rake €0.04
Board [Ac Td Kh 8h]
Seat 1: Luckers712 (button) collected (€0.83)
Seat 2: masquisiera (small blind) folded before Flop
Seat 3: portospouto (big blind) folded before Flop
Seat 4: marsatack28 folded on the Turn
Seat 5: Anme41 folded before Flop (didn't bet)
Seat 6: xateadoo folded before Flop (didn't bet)



PokerStars Zoom Hand #210170916024:  Hold'em No Limit (€0.01/€0.02) - 2020/03/15 19:49:04 CET [2020/03/15 14:49:04 ET]
Table 'Arneb' 6-max Seat #1 is the button
Seat 1: XaviXav91 (€0.93 in chips)
Seat 2: pandemon (€5.72 in chips)
Seat 3: Luckers712 (€5.92 in chips)
Seat 4: amotinado85 (€2 in chips)
Seat 5: agus166 (€2 in chips)
Seat 6: Orisso30 (€2.04 in chips)
pandemon: posts small blind €0.01
Luckers712: posts big blind €0.02
*** HOLE CARDS ***
Dealt to Luckers712 [5c 7s]
amotinado85: folds
agus166: folds
Orisso30: folds
XaviXav91: calls €0.02
pandemon: folds
Luckers712: checks
*** FLOP *** [Jd Td Kh]
Luckers712: checks
XaviXav91: checks
*** TURN *** [Jd Td Kh] [5h]
Luckers712: checks
XaviXav91: checks
*** RIVER *** [Jd Td Kh 5h] [Ah]
Luckers712: checks
XaviXav91: checks
*** SHOW DOWN ***
Luckers712: shows [5c 7s] (a pair of Fives)
XaviXav91: mucks hand
Luckers712 collected €0.05 from pot
*** SUMMARY ***
Total pot €0.05 | Rake €0
Board [Jd Td Kh 5h Ah]
Seat 1: XaviXav91 (button) mucked [9c 2c]
Seat 2: pandemon (small blind) folded before Flop
Seat 3: Luckers712 (big blind) showed [5c 7s] and won (€0.05) with a pair of Fives
Seat 4: amotinado85 folded before Flop (didn't bet)
Seat 5: agus166 folded before Flop (didn't bet)
Seat 6: Orisso30 folded before Flop (didn't bet)



PokerStars Zoom Hand #210170947926:  Hold'em No Limit (€0.01/€0.02) - 2020/03/15 19:49:38 CET [2020/03/15 14:49:38 ET]
Table 'Arneb' 6-max Seat #1 is the button
Seat 1: Vitorhcsousa (€4.62 in chips)
Seat 2: kubrick10 (€1.87 in chips)
Seat 3: bandittours (€3.88 in chips)
Seat 4: lusto09 (€3.57 in chips)
Seat 5: Luckers712 (€5.95 in chips)
Seat 6: lunasa (€2 in chips)
kubrick10: posts small blind €0.01
bandittours: posts big blind €0.02
*** HOLE CARDS ***
Dealt to Luckers712 [4s 2d]
lusto09: folds
Luckers712: folds
lunasa: folds
Vitorhcsousa: raises €0.03 to €0.05
kubrick10: folds
bandittours: folds
Uncalled bet (€0.03) returned to Vitorhcsousa
Vitorhcsousa collected €0.05 from pot
Vitorhcsousa: doesn't show hand
*** SUMMARY ***
Total pot €0.05 | Rake €0
Seat 1: Vitorhcsousa (button) collected (€0.05)
Seat 2: kubrick10 (small blind) folded before Flop
Seat 3: bandittours (big blind) folded before Flop
Seat 4: lusto09 folded before Flop (didn't bet)
Seat 5: Luckers712 folded before Flop (didn't bet)
Seat 6: lunasa folded before Flop (didn't bet)



PokerStars Zoom Hand #210170951659:  Hold'em No Limit (€0.01/€0.02) - 2020/03/15 19:49:42 CET [2020/03/15 14:49:42 ET]
Table 'Arneb' 6-max Seat #1 is the button
Seat 1: xikiniki1 (€2.14 in chips)
Seat 2: SonsOfFun (€2.12 in chips)
Seat 3: serbot131 (€4.94 in chips)
Seat 4: Luckers712 (€5.95 in chips)
Seat 5: LuisMatos27 (€2.53 in chips)
Seat 6: Facs10 (€1.87 in chips)
SonsOfFun: posts small blind €0.01
serbot131: posts big blind €0.02
*** HOLE CARDS ***
Dealt to Luckers712 [Qc Kd]
Luckers712: raises €0.04 to €0.06
LuisMatos27: folds
Facs10: folds
xikiniki1: folds
SonsOfFun: folds
serbot131: calls €0.04
*** FLOP *** [Jd 8h 7h]
serbot131: checks
Luckers712: checks
*** TURN *** [Jd 8h 7h] [Ks]
serbot131: checks
Luckers712: bets €0.08
serbot131: folds
Uncalled bet (€0.08) returned to Luckers712
Luckers712 collected €0.12 from pot
Luckers712: doesn't show hand
*** SUMMARY ***
Total pot €0.13 | Rake €0.01
Board [Jd 8h 7h Ks]
Seat 1: xikiniki1 (button) folded before Flop (didn't bet)
Seat 2: SonsOfFun (small blind) folded before Flop
Seat 3: serbot131 (big blind) folded on the Turn
Seat 4: Luckers712 collected (€0.12)
Seat 5: LuisMatos27 folded before Flop (didn't bet)
Seat 6: Facs10 folded before Flop (didn't bet)



PokerStars Zoom Hand #210170987651:  Hold'em No Limit (€0.01/€0.02) - 2020/03/15 19:50:21 CET [2020/03/15 14:50:21 ET]
Table 'Arneb' 6-max Seat #1 is the button
Seat 1: Luckers712 (€6 in chips)
Seat 2: colgao87 (€4.37 in chips)
Seat 3: soulfunk1 (€3.65 in chips)
Seat 4: petitgold (€3.87 in chips)
Seat 5: MMMJLMALM (€1 in chips)
Seat 6: DNooXLvv (€6.88 in chips)
colgao87: posts small blind €0.01
soulfunk1: posts big blind €0.02
*** HOLE CARDS ***
Dealt to Luckers712 [2d 9h]
petitgold: folds
MMMJLMALM: folds
DNooXLvv: folds
Luckers712: folds
colgao87: folds
Uncalled bet (€0.01) returned to soulfunk1
soulfunk1 collected €0.02 from pot
soulfunk1: doesn't show hand
*** SUMMARY ***
Total pot €0.02 | Rake €0
Seat 1: Luckers712 (button) folded before Flop (didn't bet)
Seat 2: colgao87 (small blind) folded before Flop
Seat 3: soulfunk1 (big blind) collected (€0.02)
Seat 4: petitgold folded before Flop (didn't bet)
Seat 5: MMMJLMALM folded before Flop (didn't bet)
Seat 6: DNooXLvv folded before Flop (didn't bet)



PokerStars Zoom Hand #210170983958:  Hold'em No Limit (€0.01/€0.02) - 2020/03/15 19:50:17 CET [2020/03/15 14:50:17 ET]
Table 'Arneb' 6-max Seat #1 is the button
Seat 1: Carma312 (€2.84 in chips)
Seat 2: Luckers712 (€6.01 in chips)
Seat 3: ismasu (€4.64 in chips)
Seat 4: TheKing11597 (€2.21 in chips)
Seat 5: vitormanu120 (€1.54 in chips)
Seat 6: Franç@ (€8.93 in chips)
Luckers712: posts small blind €0.01
ismasu: posts big blind €0.02
*** HOLE CARDS ***
Dealt to Luckers712 [Qc 5s]
TheKing11597: folds
vitormanu120: folds
Franç@: folds
Carma312: folds
Luckers712: folds
Uncalled bet (€0.01) returned to ismasu
ismasu collected €0.02 from pot
ismasu: doesn't show hand
*** SUMMARY ***
Total pot €0.02 | Rake €0
Seat 1: Carma312 (button) folded before Flop (didn't bet)
Seat 2: Luckers712 (small blind) folded before Flop
Seat 3: ismasu (big blind) collected (€0.02)
Seat 4: TheKing11597 folded before Flop (didn't bet)
Seat 5: vitormanu120 folded before Flop (didn't bet)
Seat 6: Franç@ folded before Flop (didn't bet)



PokerStars Zoom Hand #210170996905:  Hold'em No Limit (€0.01/€0.02) - 2020/03/15 19:50:31 CET [2020/03/15 14:50:31 ET]
Table 'Arneb' 6-max Seat #1 is the button
Seat 1: Capitan Aab (€2.06 in chips)
Seat 2: colgao87 (€1.77 in chips)
Seat 3: petitgold (€3.87 in chips)
Seat 4: mahale81 (€2.13 in chips)
Seat 5: serbot131 (€4.87 in chips)
Seat 6: Luckers712 (€6 in chips)
colgao87: posts small blind €0.01
petitgold: posts big blind €0.02
*** HOLE CARDS ***
Dealt to Luckers712 [2c 2d]
mahale81: folds
serbot131: folds
Luckers712: raises €0.03 to €0.05
Capitan Aab: folds
colgao87: folds
petitgold: folds
Uncalled bet (€0.03) returned to Luckers712
Luckers712 collected €0.05 from pot
Luckers712: doesn't show hand
*** SUMMARY ***
Total pot €0.05 | Rake €0
Seat 1: Capitan Aab (button) folded before Flop (didn't bet)
Seat 2: colgao87 (small blind) folded before Flop
Seat 3: petitgold (big blind) folded before Flop
Seat 4: mahale81 folded before Flop (didn't bet)
Seat 5: serbot131 folded before Flop (didn't bet)
Seat 6: Luckers712 collected (€0.05)



PokerStars Zoom Hand #210170992394:  Hold'em No Limit (€0.01/€0.02) - 2020/03/15 19:50:26 CET [2020/03/15 14:50:26 ET]
Table 'Arneb' 6-max Seat #1 is the button
Seat 1: bandittours (€2.03 in chips)
Seat 2: afrodit83 (€0.82 in chips)
Seat 3: lunasa (€3.82 in chips)
Seat 4: Luckers712 (€6 in chips)
Seat 5: slaton (€2.03 in chips)
Seat 6: serbot131 (€4.87 in chips)
afrodit83: posts small blind €0.01
lunasa: posts big blind €0.02
*** HOLE CARDS ***
Dealt to Luckers712 [4s 3s]
Luckers712: folds
slaton: folds
serbot131: folds
bandittours: folds
afrodit83: raises €0.03 to €0.05
lunasa: calls €0.03
*** FLOP *** [Ad Jh Td]
afrodit83: bets €0.05
lunasa: calls €0.05
*** TURN *** [Ad Jh Td] [3c]
afrodit83: bets €0.10
lunasa: folds
Uncalled bet (€0.10) returned to afrodit83
afrodit83 collected €0.19 from pot
afrodit83: doesn't show hand
*** SUMMARY ***
Total pot €0.20 | Rake €0.01
Board [Ad Jh Td 3c]
Seat 1: bandittours (button) folded before Flop (didn't bet)
Seat 2: afrodit83 (small blind) collected (€0.19)
Seat 3: lunasa (big blind) folded on the Turn
Seat 4: Luckers712 folded before Flop (didn't bet)
Seat 5: slaton folded before Flop (didn't bet)
Seat 6: serbot131 folded before Flop (didn't bet)



PokerStars Zoom Hand #210171024700:  Hold'em No Limit (€0.01/€0.02) - 2020/03/15 19:50:55 CET [2020/03/15 14:50:55 ET]
Table 'Arneb' 6-max Seat #1 is the button
Seat 1: Robersaz (€3.01 in chips)
Seat 2: Púlsar (€2.56 in chips)
Seat 3: Luckers712 (€6.02 in chips)
Seat 4: campanilla06 (€1.47 in chips)
Seat 5: fullba31 (€2.84 in chips)
Seat 6: Mokoo98 (€2 in chips)
Púlsar: posts small blind €0.01
Luckers712: posts big blind €0.02
*** HOLE CARDS ***
Dealt to Luckers712 [6d Ts]
campanilla06: folds
fullba31: folds
Mokoo98: raises €0.02 to €0.04
Robersaz: folds
Púlsar: calls €0.03
Luckers712: folds
*** FLOP *** [5d 8s Jc]
Púlsar: checks
Mokoo98: checks
*** TURN *** [5d 8s Jc] [Tc]
Púlsar: checks
Mokoo98: checks
*** RIVER *** [5d 8s Jc Tc] [Kd]
Púlsar: checks
Mokoo98: bets €0.07
Púlsar: folds
Uncalled bet (€0.07) returned to Mokoo98
Mokoo98 collected €0.10 from pot
Mokoo98: doesn't show hand
*** SUMMARY ***
Total pot €0.10 | Rake €0
Board [5d 8s Jc Tc Kd]
Seat 1: Robersaz (button) folded before Flop (didn't bet)
Seat 2: Púlsar (small blind) folded on the River
Seat 3: Luckers712 (big blind) folded before Flop
Seat 4: campanilla06 folded before Flop (didn't bet)
Seat 5: fullba31 folded before Flop (didn't bet)
Seat 6: Mokoo98 collected (€0.10)



PokerStars Zoom Hand #210171021062:  Hold'em No Limit (€0.01/€0.02) - 2020/03/15 19:50:51 CET [2020/03/15 14:50:51 ET]
Table 'Arneb' 6-max Seat #1 is the button
Seat 1: colgao87 (€4.34 in chips)
Seat 2: Luckers712 (€6.03 in chips)
Seat 3: agus166 (€2 in chips)
Seat 4: magnadaniel (€0.66 in chips)
Seat 5: TheKing11597 (€2.23 in chips)
Seat 6: serbot131 (€2.63 in chips)
Luckers712: posts small blind €0.01
agus166: posts big blind €0.02
*** HOLE CARDS ***
Dealt to Luckers712 [5h 4s]
magnadaniel: folds
TheKing11597: folds
serbot131: raises €0.05 to €0.07
colgao87: folds
Luckers712: folds
agus166: calls €0.05
*** FLOP *** [9h 6h Ad]
agus166: checks
serbot131: checks
*** TURN *** [9h 6h Ad] [Th]
agus166: checks
serbot131: checks
*** RIVER *** [9h 6h Ad Th] [Ah]
agus166: bets €0.05
serbot131: raises €0.23 to €0.28
agus166: calls €0.23
*** SHOW DOWN ***
serbot131: shows [Qd Kh] (a flush, Ace high)
agus166: mucks hand
serbot131 collected €0.67 from pot
*** SUMMARY ***
Total pot €0.71 | Rake €0.04
Board [9h 6h Ad Th Ah]
Seat 1: colgao87 (button) folded before Flop (didn't bet)
Seat 2: Luckers712 (small blind) folded before Flop
Seat 3: agus166 (big blind) mucked [Tc Jh]
Seat 4: magnadaniel folded before Flop (didn't bet)
Seat 5: TheKing11597 folded before Flop (didn't bet)
Seat 6: serbot131 showed [Qd Kh] and won (€0.67) with a flush, Ace high



PokerStars Zoom Hand #210171034949:  Hold'em No Limit (€0.01/€0.02) - 2020/03/15 19:51:06 CET [2020/03/15 14:51:06 ET]
Table 'Arneb' 6-max Seat #1 is the button
Seat 1: shegotcakes (€2 in chips)
Seat 2: manuelsg89 (€4.72 in chips)
Seat 3: GLBluff88 (€2 in chips)
Seat 4: ChaCha120488 (€1.11 in chips)
Seat 5: Luckers712 (€6 in chips)
Seat 6: bilboubou78 (€3.20 in chips)
manuelsg89: posts small blind €0.01
GLBluff88: posts big blind €0.02
*** HOLE CARDS ***
Dealt to Luckers712 [As Ac]
ChaCha120488: folds
Luckers712: raises €0.03 to €0.05
bilboubou78: folds
shegotcakes: calls €0.05
manuelsg89: folds
GLBluff88: folds
*** FLOP *** [4s 8c Kc]
Luckers712: checks
shegotcakes: checks
*** TURN *** [4s 8c Kc] [7c]
Luckers712: checks
shegotcakes: checks
*** RIVER *** [4s 8c Kc 7c] [Qh]
Luckers712: bets €0.14
shegotcakes: folds
Uncalled bet (€0.14) returned to Luckers712
Luckers712 collected €0.12 from pot
Luckers712: doesn't show hand
*** SUMMARY ***
Total pot €0.13 | Rake €0.01
Board [4s 8c Kc 7c Qh]
Seat 1: shegotcakes (button) folded on the River
Seat 2: manuelsg89 (small blind) folded before Flop
Seat 3: GLBluff88 (big blind) folded before Flop
Seat 4: ChaCha120488 folded before Flop (didn't bet)
Seat 5: Luckers712 collected (€0.12)
Seat 6: bilboubou78 folded before Flop (didn't bet)



PokerStars Zoom Hand #210171099611:  Hold'em No Limit (€0.01/€0.02) - 2020/03/15 19:52:15 CET [2020/03/15 14:52:15 ET]
Table 'Arneb' 6-max Seat #1 is the button
Seat 1: tatanekiki (€3.78 in chips)
Seat 2: DarkLord2104 (€2.07 in chips)
Seat 3: shegotcakes (€2 in chips)
Seat 4: Luckers712 (€6.07 in chips)
Seat 5: DNooXLvv (€3.65 in chips)
Seat 6: Vitibou (€1.97 in chips)
DarkLord2104: posts small blind €0.01
shegotcakes: posts big blind €0.02
*** HOLE CARDS ***
Dealt to Luckers712 [Qd Td]
Luckers712: raises €0.03 to €0.05
DNooXLvv: folds
Vitibou: folds
tatanekiki: calls €0.05
DarkLord2104: folds
shegotcakes: folds
*** FLOP *** [6d 9s 8d]
Luckers712: checks
tatanekiki: checks
*** TURN *** [6d 9s 8d] [2d]
Luckers712: bets €0.20
tatanekiki: folds
Uncalled bet (€0.20) returned to Luckers712
Luckers712 collected €0.12 from pot
Luckers712: doesn't show hand
*** SUMMARY ***
Total pot €0.13 | Rake €0.01
Board [6d 9s 8d 2d]
Seat 1: tatanekiki (button) folded on the Turn
Seat 2: DarkLord2104 (small blind) folded before Flop
Seat 3: shegotcakes (big blind) folded before Flop
Seat 4: Luckers712 collected (€0.12)
Seat 5: DNooXLvv folded before Flop (didn't bet)
Seat 6: Vitibou folded before Flop (didn't bet)



PokerStars Zoom Hand #210171137698:  Hold'em No Limit (€0.01/€0.02) - 2020/03/15 19:52:55 CET [2020/03/15 14:52:55 ET]
Table 'Arneb' 6-max Seat #1 is the button
Seat 1: SonsOfFun (€3.23 in chips)
Seat 2: Seron1023 (€2.28 in chips)
Seat 3: slaton (€2 in chips)
Seat 4: Alibasy (€3.34 in chips)
Seat 5: pabmesa (€1.02 in chips)
Seat 6: Luckers712 (€6.14 in chips)
Seron1023: posts small blind €0.01
slaton: posts big blind €0.02
*** HOLE CARDS ***
Dealt to Luckers712 [Qc 3h]
Alibasy: folds
pabmesa: folds
Luckers712: folds
SonsOfFun: folds
Seron1023: calls €0.01
slaton: raises €0.08 to €0.10
Seron1023: folds
Uncalled bet (€0.08) returned to slaton
slaton collected €0.04 from pot
slaton: doesn't show hand
*** SUMMARY ***
Total pot €0.04 | Rake €0
Seat 1: SonsOfFun (button) folded before Flop (didn't bet)
Seat 2: Seron1023 (small blind) folded before Flop
Seat 3: slaton (big blind) collected (€0.04)
Seat 4: Alibasy folded before Flop (didn't bet)
Seat 5: pabmesa folded before Flop (didn't bet)
Seat 6: Luckers712 folded before Flop (didn't bet)



PokerStars Zoom Hand #210171144249:  Hold'em No Limit (€0.01/€0.02) - 2020/03/15 19:53:03 CET [2020/03/15 14:53:03 ET]
Table 'Arneb' 6-max Seat #1 is the button
Seat 1: ERIZOCACHO (€0.77 in chips)
Seat 2: chiwas12 (€2 in chips)
Seat 3: MaldiniCapitano (€2.80 in chips)
Seat 4: pandemon (€5.80 in chips)
Seat 5: Luckers712 (€6.14 in chips)
Seat 6: eslavoneslavon (€0.65 in chips)
chiwas12: posts small blind €0.01
MaldiniCapitano: posts big blind €0.02
*** HOLE CARDS ***
Dealt to Luckers712 [5h 5c]
pandemon: folds
Luckers712: raises €0.03 to €0.05
eslavoneslavon: raises €0.13 to €0.18
ERIZOCACHO: folds
chiwas12: folds
MaldiniCapitano: folds
Luckers712: raises €5.96 to €6.14 and is all-in
eslavoneslavon: calls €0.47 and is all-in
Uncalled bet (€5.49) returned to Luckers712
*** FLOP *** [7s 2c 4c]
*** TURN *** [7s 2c 4c] [Ah]
*** RIVER *** [7s 2c 4c Ah] [Jh]
*** SHOW DOWN ***
Luckers712: shows [5h 5c] (a pair of Fives)
eslavoneslavon: shows [6c 6h] (a pair of Sixes)
eslavoneslavon collected €1.26 from pot
*** SUMMARY ***
Total pot €1.33 | Rake €0.07
Board [7s 2c 4c Ah Jh]
Seat 1: ERIZOCACHO (button) folded before Flop (didn't bet)
Seat 2: chiwas12 (small blind) folded before Flop
Seat 3: MaldiniCapitano (big blind) folded before Flop
Seat 4: pandemon folded before Flop (didn't bet)
Seat 5: Luckers712 showed [5h 5c] and lost with a pair of Fives
Seat 6: eslavoneslavon showed [6c 6h] and won (€1.26) with a pair of Sixes



PokerStars Zoom Hand #210171175352:  Hold'em No Limit (€0.01/€0.02) - 2020/03/15 19:53:35 CET [2020/03/15 14:53:35 ET]
Table 'Arneb' 6-max Seat #1 is the button
Seat 1: MaldiniCapitano (€3.78 in chips)
Seat 2: Sespir (€2.96 in chips)
Seat 3: Luckers712 (€5.49 in chips)
Seat 4: unounoporfavor (€2.31 in chips)
Seat 5: eslavoneslavon (€1.26 in chips)
Seat 6: ricmp (€4.49 in chips)
Sespir: posts small blind €0.01
Luckers712: posts big blind €0.02
*** HOLE CARDS ***
Dealt to Luckers712 [9s Ac]
unounoporfavor: folds
eslavoneslavon: folds
ricmp: folds
MaldiniCapitano: folds
Sespir: raises €0.03 to €0.05
Luckers712: calls €0.03
*** FLOP *** [3d 3h 7h]
Sespir: checks
Luckers712: checks
*** TURN *** [3d 3h 7h] [4d]
Sespir: checks
Luckers712: bets €0.06
Sespir: calls €0.06
*** RIVER *** [3d 3h 7h 4d] [Tc]
Sespir: checks
Luckers712: checks
*** SHOW DOWN ***
Sespir: shows [2s 2c] (two pair, Threes and Deuces)
Luckers712: mucks hand
Sespir collected €0.21 from pot
*** SUMMARY ***
Total pot €0.22 | Rake €0.01
Board [3d 3h 7h 4d Tc]
Seat 1: MaldiniCapitano (button) folded before Flop (didn't bet)
Seat 2: Sespir (small blind) showed [2s 2c] and won (€0.21) with two pair, Threes and Deuces
Seat 3: Luckers712 (big blind) mucked [9s Ac]
Seat 4: unounoporfavor folded before Flop (didn't bet)
Seat 5: eslavoneslavon folded before Flop (didn't bet)
Seat 6: ricmp folded before Flop (didn't bet)



PokerStars Zoom Hand #210171221752:  Hold'em No Limit (€0.01/€0.02) - 2020/03/15 19:54:24 CET [2020/03/15 14:54:24 ET]
Table 'Arneb' 6-max Seat #1 is the button
Seat 1: Luckers712 (€5.38 in chips)
Seat 2: bilboubou78 (€1.95 in chips)
Seat 3: Jagf0010 (€2.03 in chips)
Seat 4: campanilla06 (€1.77 in chips)
Seat 5: ERIZOCACHO (€0.74 in chips)
Seat 6: LuisMatos27 (€2 in chips)
bilboubou78: posts small blind €0.01
Jagf0010: posts big blind €0.02
*** HOLE CARDS ***
Dealt to Luckers712 [Ts 9h]
campanilla06: raises €0.04 to €0.06
ERIZOCACHO: folds
LuisMatos27: folds
Luckers712: folds
bilboubou78: folds
Jagf0010: folds
Uncalled bet (€0.04) returned to campanilla06
campanilla06 collected €0.05 from pot
campanilla06: doesn't show hand
*** SUMMARY ***
Total pot €0.05 | Rake €0
Seat 1: Luckers712 (button) folded before Flop (didn't bet)
Seat 2: bilboubou78 (small blind) folded before Flop
Seat 3: Jagf0010 (big blind) folded before Flop
Seat 4: campanilla06 collected (€0.05)
Seat 5: ERIZOCACHO folded before Flop (didn't bet)
Seat 6: LuisMatos27 folded before Flop (didn't bet)



PokerStars Zoom Hand #210171226399:  Hold'em No Limit (€0.01/€0.02) - 2020/03/15 19:54:30 CET [2020/03/15 14:54:30 ET]
Table 'Arneb' 6-max Seat #1 is the button
Seat 1: TheKing11597 (€2.53 in chips)
Seat 2: Luckers712 (€5.38 in chips)
Seat 3: lopes19771310 (€1.97 in chips)
Seat 4: Dark_make632 (€2 in chips)
Seat 5: Orisso30 (€2 in chips)
Seat 6: GLBluff88 (€2 in chips)
Luckers712: posts small blind €0.01
lopes19771310: posts big blind €0.02
*** HOLE CARDS ***
Dealt to Luckers712 [3c 3h]
Dark_make632: folds
Orisso30: folds
GLBluff88: folds
TheKing11597: folds
Luckers712: raises €0.03 to €0.05
lopes19771310: calls €0.03
*** FLOP *** [Ts 4s Jd]
Luckers712: checks
lopes19771310: checks
*** TURN *** [Ts 4s Jd] [3s]
Luckers712: bets €0.07
lopes19771310: folds
Uncalled bet (€0.07) returned to Luckers712
Luckers712 collected €0.10 from pot
Luckers712: doesn't show hand
*** SUMMARY ***
Total pot €0.10 | Rake €0
Board [Ts 4s Jd 3s]
Seat 1: TheKing11597 (button) folded before Flop (didn't bet)
Seat 2: Luckers712 (small blind) collected (€0.10)
Seat 3: lopes19771310 (big blind) folded on the Turn
Seat 4: Dark_make632 folded before Flop (didn't bet)
Seat 5: Orisso30 folded before Flop (didn't bet)
Seat 6: GLBluff88 folded before Flop (didn't bet)



PokerStars Zoom Hand #210171271385:  Hold'em No Limit (€0.01/€0.02) - 2020/03/15 19:55:18 CET [2020/03/15 14:55:18 ET]
Table 'Arneb' 6-max Seat #1 is the button
Seat 1: manuelsg89 (€2.61 in chips)
Seat 2: xPeskailla (€2 in chips)
Seat 3: Luckers712 (€5.43 in chips)
Seat 4: recis (€4.35 in chips)
Seat 5: portu35 (€2 in chips)
Seat 6: Púlsar (€3.57 in chips)
xPeskailla: posts small blind €0.01
Luckers712: posts big blind €0.02
*** HOLE CARDS ***
Dealt to Luckers712 [4h Jc]
recis: raises €0.05 to €0.07
portu35: folds
Púlsar: folds
manuelsg89: folds
xPeskailla: folds
Luckers712: folds
Uncalled bet (€0.05) returned to recis
recis collected €0.05 from pot
recis: doesn't show hand
*** SUMMARY ***
Total pot €0.05 | Rake €0
Seat 1: manuelsg89 (button) folded before Flop (didn't bet)
Seat 2: xPeskailla (small blind) folded before Flop
Seat 3: Luckers712 (big blind) folded before Flop
Seat 4: recis collected (€0.05)
Seat 5: portu35 folded before Flop (didn't bet)
Seat 6: Púlsar folded before Flop (didn't bet)



PokerStars Zoom Hand #210171275669:  Hold'em No Limit (€0.01/€0.02) - 2020/03/15 19:55:26 CET [2020/03/15 14:55:26 ET]
Table 'Arneb' 6-max Seat #1 is the button
Seat 1: Luckers712 (€5.41 in chips)
Seat 2: KETETEMETO46 (€0.90 in chips)
Seat 3: Melsant8 (€2 in chips)
Seat 4: tatanekiki (€3.58 in chips)
Seat 5: mesko19 (€2.13 in chips)
Seat 6: Veesile (€2.51 in chips)
KETETEMETO46: posts small blind €0.01
Melsant8: posts big blind €0.02
*** HOLE CARDS ***
Dealt to Luckers712 [Ah 3s]
tatanekiki: folds
mesko19: raises €0.04 to €0.06
Veesile: folds
Luckers712: folds
KETETEMETO46: folds
Melsant8: folds
Uncalled bet (€0.04) returned to mesko19
mesko19 collected €0.05 from pot
mesko19: doesn't show hand
*** SUMMARY ***
Total pot €0.05 | Rake €0
Seat 1: Luckers712 (button) folded before Flop (didn't bet)
Seat 2: KETETEMETO46 (small blind) folded before Flop
Seat 3: Melsant8 (big blind) folded before Flop
Seat 4: tatanekiki folded before Flop (didn't bet)
Seat 5: mesko19 collected (€0.05)
Seat 6: Veesile folded before Flop (didn't bet)



PokerStars Zoom Hand #210171266378:  Hold'em No Limit (€0.01/€0.02) - 2020/03/15 19:55:12 CET [2020/03/15 14:55:12 ET]
Table 'Arneb' 6-max Seat #1 is the button
Seat 1: freececi (€3.61 in chips)
Seat 2: SonsOfFun (€2.10 in chips)
Seat 3: Veesile (€2.53 in chips)
Seat 4: Kayfidze (€2.96 in chips)
Seat 5: pitufisinda (€0.55 in chips)
Seat 6: Luckers712 (€5.43 in chips)
SonsOfFun: posts small blind €0.01
Veesile: posts big blind €0.02
*** HOLE CARDS ***
Dealt to Luckers712 [Jh 9d]
Kayfidze: folds
pitufisinda: folds
Luckers712: folds
freececi: raises €0.03 to €0.05
SonsOfFun: raises €0.22 to €0.27
Veesile: folds
freececi: folds
Uncalled bet (€0.22) returned to SonsOfFun
SonsOfFun collected €0.12 from pot
SonsOfFun: doesn't show hand
*** SUMMARY ***
Total pot €0.12 | Rake €0
Seat 1: freececi (button) folded before Flop
Seat 2: SonsOfFun (small blind) collected (€0.12)
Seat 3: Veesile (big blind) folded before Flop
Seat 4: Kayfidze folded before Flop (didn't bet)
Seat 5: pitufisinda folded before Flop (didn't bet)
Seat 6: Luckers712 folded before Flop (didn't bet)



PokerStars Zoom Hand #210171262766:  Hold'em No Limit (€0.01/€0.02) - 2020/03/15 19:55:08 CET [2020/03/15 14:55:08 ET]
Table 'Arneb' 6-max Seat #1 is the button
Seat 1: melvacanutera (€3.32 in chips)
Seat 2: ERIZOCACHO (€0.62 in chips)
Seat 3: mahale81 (€1.97 in chips)
Seat 4: Luckers712 (€5.43 in chips)
Seat 5: TheKing11597 (€3.72 in chips)
Seat 6: Veesile (€2.53 in chips)
ERIZOCACHO: posts small blind €0.01
mahale81: posts big blind €0.02
*** HOLE CARDS ***
Dealt to Luckers712 [2h Qd]
Luckers712: folds
TheKing11597: raises €0.04 to €0.06
Veesile: folds
melvacanutera: raises €0.94 to €1
ERIZOCACHO: folds
mahale81: folds
TheKing11597: calls €0.94
*** FLOP *** [8s Js Kh]
TheKing11597: checks
melvacanutera: bets €0.86
TheKing11597: folds
Uncalled bet (€0.86) returned to melvacanutera
melvacanutera collected €1.93 from pot
melvacanutera: doesn't show hand
*** SUMMARY ***
Total pot €2.03 | Rake €0.10
Board [8s Js Kh]
Seat 1: melvacanutera (button) collected (€1.93)
Seat 2: ERIZOCACHO (small blind) folded before Flop
Seat 3: mahale81 (big blind) folded before Flop
Seat 4: Luckers712 folded before Flop (didn't bet)
Seat 5: TheKing11597 folded on the Flop
Seat 6: Veesile folded before Flop (didn't bet)



PokerStars Zoom Hand #210171283630:  Hold'em No Limit (€0.01/€0.02) - 2020/03/15 19:55:38 CET [2020/03/15 14:55:38 ET]
Table 'Arneb' 6-max Seat #1 is the button
Seat 1: trakson (€2.33 in chips)
Seat 2: Luckers712 (€5.41 in chips)
Seat 3: Franç@ (€8.31 in chips)
Seat 4: Veesile (€2.06 in chips)
Seat 5: guitimsa (€3.69 in chips)
Seat 6: LOUANE66 (€2.25 in chips)
Luckers712: posts small blind €0.01
Franç@: posts big blind €0.02
*** HOLE CARDS ***
Dealt to Luckers712 [5d 8c]
Veesile: folds
guitimsa: raises €0.02 to €0.04
LOUANE66: calls €0.04
trakson: folds
Luckers712: folds
Franç@: folds
*** FLOP *** [Ad 3s 7d]
guitimsa: bets €0.10
LOUANE66: folds
Uncalled bet (€0.10) returned to guitimsa
guitimsa collected €0.10 from pot
guitimsa: doesn't show hand
*** SUMMARY ***
Total pot €0.11 | Rake €0.01
Board [Ad 3s 7d]
Seat 1: trakson (button) folded before Flop (didn't bet)
Seat 2: Luckers712 (small blind) folded before Flop
Seat 3: Franç@ (big blind) folded before Flop
Seat 4: Veesile folded before Flop (didn't bet)
Seat 5: guitimsa collected (€0.10)
Seat 6: LOUANE66 folded on the Flop



PokerStars Zoom Hand #210171291828:  Hold'em No Limit (€0.01/€0.02) - 2020/03/15 19:55:52 CET [2020/03/15 14:55:52 ET]
Table 'Arneb' 6-max Seat #1 is the button
Seat 1: tonetete19 (€2 in chips)
Seat 2: bilbaostars (€3.52 in chips)
Seat 3: ElvasSniper (€2.22 in chips)
Seat 4: ismasu (€3.99 in chips)
Seat 5: Luckers712 (€5.40 in chips)
Seat 6: Marlock10 (€2 in chips)
bilbaostars: posts small blind €0.01
ElvasSniper: posts big blind €0.02
*** HOLE CARDS ***
Dealt to Luckers712 [2h 6h]
ismasu: folds
Luckers712: folds
Marlock10: folds
tonetete19: folds
bilbaostars: raises €0.02 to €0.04
ElvasSniper: folds
Uncalled bet (€0.02) returned to bilbaostars
bilbaostars collected €0.04 from pot
bilbaostars: doesn't show hand
*** SUMMARY ***
Total pot €0.04 | Rake €0
Seat 1: tonetete19 (button) folded before Flop (didn't bet)
Seat 2: bilbaostars (small blind) collected (€0.04)
Seat 3: ElvasSniper (big blind) folded before Flop
Seat 4: ismasu folded before Flop (didn't bet)
Seat 5: Luckers712 folded before Flop (didn't bet)
Seat 6: Marlock10 folded before Flop (didn't bet)



PokerStars Zoom Hand #210171295080:  Hold'em No Limit (€0.01/€0.02) - 2020/03/15 19:55:57 CET [2020/03/15 14:55:57 ET]
Table 'Arneb' 6-max Seat #1 is the button
Seat 1: MaurusT (€1.61 in chips)
Seat 2: ricmp (€12.05 in chips)
Seat 3: amotinado85 (€3.61 in chips)
Seat 4: Veesile (€3.01 in chips)
Seat 5: Aria71321 (€0.68 in chips)
Seat 6: Luckers712 (€5.40 in chips)
ricmp: posts small blind €0.01
amotinado85: posts big blind €0.02
*** HOLE CARDS ***
Dealt to Luckers712 [8c Ad]
Veesile: folds
Aria71321: folds
Luckers712: raises €0.04 to €0.06
MaurusT: folds
ricmp: folds
amotinado85: folds
Uncalled bet (€0.04) returned to Luckers712
Luckers712 collected €0.05 from pot
Luckers712: doesn't show hand
*** SUMMARY ***
Total pot €0.05 | Rake €0
Seat 1: MaurusT (button) folded before Flop (didn't bet)
Seat 2: ricmp (small blind) folded before Flop
Seat 3: amotinado85 (big blind) folded before Flop
Seat 4: Veesile folded before Flop (didn't bet)
Seat 5: Aria71321 folded before Flop (didn't bet)
Seat 6: Luckers712 collected (€0.05)



PokerStars Zoom Hand #210171288673:  Hold'em No Limit (€0.01/€0.02) - 2020/03/15 19:55:47 CET [2020/03/15 14:55:47 ET]
Table 'Arneb' 6-max Seat #1 is the button
Seat 1: Veesile (€2.06 in chips)
Seat 2: jorge2626 (€3.54 in chips)
Seat 3: Rppopy (€3.89 in chips)
Seat 4: Luckers712 (€5.40 in chips)
Seat 5: kün Chiquero (€2.10 in chips)
Seat 6: agus166 (€2 in chips)
jorge2626: posts small blind €0.01
Rppopy: posts big blind €0.02
*** HOLE CARDS ***
Dealt to Luckers712 [4s 5c]
Luckers712: folds
kün Chiquero: calls €0.02
agus166: folds
Veesile: folds
jorge2626: calls €0.01
Rppopy: checks
*** FLOP *** [2s Jh 7s]
jorge2626: bets €0.05
Rppopy: calls €0.05
kün Chiquero: folds
*** TURN *** [2s Jh 7s] [9s]
jorge2626: checks
Rppopy: checks
*** RIVER *** [2s Jh 7s 9s] [9d]
jorge2626: checks
Rppopy: checks
*** SHOW DOWN ***
jorge2626: shows [Jd Qc] (two pair, Jacks and Nines)
Rppopy: mucks hand
jorge2626 collected €0.15 from pot
*** SUMMARY ***
Total pot €0.16 | Rake €0.01
Board [2s Jh 7s 9s 9d]
Seat 1: Veesile (button) folded before Flop (didn't bet)
Seat 2: jorge2626 (small blind) showed [Jd Qc] and won (€0.15) with two pair, Jacks and Nines
Seat 3: Rppopy (big blind) mucked [Kh 7h]
Seat 4: Luckers712 folded before Flop (didn't bet)
Seat 5: kün Chiquero folded on the Flop
Seat 6: agus166 folded before Flop (didn't bet)



PokerStars Zoom Hand #210171286112:  Hold'em No Limit (€0.01/€0.02) - 2020/03/15 19:55:42 CET [2020/03/15 14:55:42 ET]
Table 'Arneb' 6-max Seat #1 is the button
Seat 1: squall2009 (€1 in chips)
Seat 2: Alibasy (€3.31 in chips)
Seat 3: SonsOfFun (€2.17 in chips)
Seat 4: AgusMamba23 (€1.92 in chips)
Seat 5: Luckers712 (€5.40 in chips)
Seat 6: boalju (€1.57 in chips)
Alibasy: posts small blind €0.01
SonsOfFun: posts big blind €0.02
*** HOLE CARDS ***
Dealt to Luckers712 [4c 7d]
AgusMamba23: folds
Luckers712: folds
boalju: folds
squall2009: folds
Alibasy: raises €0.04 to €0.06
SonsOfFun: raises €2.11 to €2.17 and is all-in
Alibasy: calls €2.11
*** FLOP *** [3d 2h Jd]
*** TURN *** [3d 2h Jd] [Ah]
*** RIVER *** [3d 2h Jd Ah] [6h]
*** SHOW DOWN ***
Alibasy: shows [4h Kh] (a flush, Ace high)
SonsOfFun: shows [As Ks] (a pair of Aces)
Alibasy collected €4.12 from pot
*** SUMMARY ***
Total pot €4.34 | Rake €0.22
Board [3d 2h Jd Ah 6h]
Seat 1: squall2009 (button) folded before Flop (didn't bet)
Seat 2: Alibasy (small blind) showed [4h Kh] and won (€4.12) with a flush, Ace high
Seat 3: SonsOfFun (big blind) showed [As Ks] and lost with a pair of Aces
Seat 4: AgusMamba23 folded before Flop (didn't bet)
Seat 5: Luckers712 folded before Flop (didn't bet)
Seat 6: boalju folded before Flop (didn't bet)



PokerStars Zoom Hand #210171304445:  Hold'em No Limit (€0.01/€0.02) - 2020/03/15 19:56:12 CET [2020/03/15 14:56:12 ET]
Table 'Arneb' 6-max Seat #1 is the button
Seat 1: campanilla06 (€1.73 in chips)
Seat 2: tulcio (€2 in chips)
Seat 3: tuga33312 (€2.93 in chips)
Seat 4: Luckers712 (€5.43 in chips)
Seat 5: ERIZOCACHO (€1.66 in chips)
Seat 6: trapaguille (€1.25 in chips)
tulcio: posts small blind €0.01
tuga33312: posts big blind €0.02
*** HOLE CARDS ***
Dealt to Luckers712 [2d 5c]
Luckers712: folds
ERIZOCACHO: folds
trapaguille: folds
campanilla06: folds
tulcio: raises €0.03 to €0.05
tuga33312: folds
Uncalled bet (€0.03) returned to tulcio
tulcio collected €0.04 from pot
tulcio: doesn't show hand
*** SUMMARY ***
Total pot €0.04 | Rake €0
Seat 1: campanilla06 (button) folded before Flop (didn't bet)
Seat 2: tulcio (small blind) collected (€0.04)
Seat 3: tuga33312 (big blind) folded before Flop
Seat 4: Luckers712 folded before Flop (didn't bet)
Seat 5: ERIZOCACHO folded before Flop (didn't bet)
Seat 6: trapaguille folded before Flop (didn't bet)



PokerStars Zoom Hand #210171306962:  Hold'em No Limit (€0.01/€0.02) - 2020/03/15 19:56:16 CET [2020/03/15 14:56:16 ET]
Table 'Arneb' 6-max Seat #1 is the button
Seat 1: Marlock10 (€2 in chips)
Seat 2: aportiquevoy (€2.14 in chips)
Seat 3: Luckers712 (€5.43 in chips)
Seat 4: PrOdI11 (€2 in chips)
Seat 5: TheKing11597 (€4 in chips)
Seat 6: bilboubou78 (€7.04 in chips)
aportiquevoy: posts small blind €0.01
Luckers712: posts big blind €0.02
*** HOLE CARDS ***
Dealt to Luckers712 [9c Qh]
PrOdI11: raises €0.02 to €0.04
TheKing11597: folds
bilboubou78: folds
Marlock10: folds
aportiquevoy: folds
Luckers712: calls €0.02
*** FLOP *** [9d Jd Qd]
Luckers712: bets €0.03
PrOdI11: folds
Uncalled bet (€0.03) returned to Luckers712
Luckers712 collected €0.09 from pot
Luckers712: doesn't show hand
*** SUMMARY ***
Total pot €0.09 | Rake €0
Board [9d Jd Qd]
Seat 1: Marlock10 (button) folded before Flop (didn't bet)
Seat 2: aportiquevoy (small blind) folded before Flop
Seat 3: Luckers712 (big blind) collected (€0.09)
Seat 4: PrOdI11 folded on the Flop
Seat 5: TheKing11597 folded before Flop (didn't bet)
Seat 6: bilboubou78 folded before Flop (didn't bet)



PokerStars Zoom Hand #210171325252:  Hold'em No Limit (€0.01/€0.02) - 2020/03/15 19:56:45 CET [2020/03/15 14:56:45 ET]
Table 'Arneb' 6-max Seat #1 is the button
Seat 1: boalju (€1.29 in chips)
Seat 2: Luckers712 (€5.48 in chips)
Seat 3: colgao87 (€1.71 in chips)
Seat 4: tulcio (€2.05 in chips)
Seat 5: 14marcelo14 (€1.57 in chips)
Seat 6: Robersaz (€3.68 in chips)
Luckers712: posts small blind €0.01
colgao87: posts big blind €0.02
*** HOLE CARDS ***
Dealt to Luckers712 [Tc Jh]
tulcio: folds
14marcelo14: folds
Robersaz: folds
boalju: raises €0.04 to €0.06
Luckers712: folds
colgao87: folds
Uncalled bet (€0.04) returned to boalju
boalju collected €0.05 from pot
boalju: doesn't show hand
*** SUMMARY ***
Total pot €0.05 | Rake €0
Seat 1: boalju (button) collected (€0.05)
Seat 2: Luckers712 (small blind) folded before Flop
Seat 3: colgao87 (big blind) folded before Flop
Seat 4: tulcio folded before Flop (didn't bet)
Seat 5: 14marcelo14 folded before Flop (didn't bet)
Seat 6: Robersaz folded before Flop (didn't bet)



PokerStars Zoom Hand #210171340257:  Hold'em No Limit (€0.01/€0.02) - 2020/03/15 19:57:09 CET [2020/03/15 14:57:09 ET]
Table 'Arneb' 6-max Seat #1 is the button
Seat 1: Luckers712 (€5.47 in chips)
Seat 2: Agorey142 (€1.48 in chips)
Seat 3: pitufisinda (€1.02 in chips)
Seat 4: campanilla06 (€1.73 in chips)
Seat 5: TheKing11597 (€4 in chips)
Seat 6: bilboubou78 (€3.77 in chips)
Agorey142: posts small blind €0.01
pitufisinda: posts big blind €0.02
*** HOLE CARDS ***
Dealt to Luckers712 [7d 4d]
campanilla06: folds
TheKing11597: folds
bilboubou78: folds
Luckers712: raises €0.03 to €0.05
Agorey142: folds
pitufisinda: calls €0.03
*** FLOP *** [3h Th 2h]
pitufisinda: checks
Luckers712: bets €0.03
pitufisinda: calls €0.03
*** TURN *** [3h Th 2h] [5h]
pitufisinda: checks
Luckers712: checks
*** RIVER *** [3h Th 2h 5h] [5c]
pitufisinda: checks
Luckers712: bets €0.06
pitufisinda: calls €0.06
*** SHOW DOWN ***
Luckers712: shows [7d 4d] (a pair of Fives)
pitufisinda: shows [Ac Qs] (a pair of Fives - Ace kicker)
pitufisinda collected €0.28 from pot
*** SUMMARY ***
Total pot €0.29 | Rake €0.01
Board [3h Th 2h 5h 5c]
Seat 1: Luckers712 (button) showed [7d 4d] and lost with a pair of Fives
Seat 2: Agorey142 (small blind) folded before Flop
Seat 3: pitufisinda (big blind) showed [Ac Qs] and won (€0.28) with a pair of Fives
Seat 4: campanilla06 folded before Flop (didn't bet)
Seat 5: TheKing11597 folded before Flop (didn't bet)
Seat 6: bilboubou78 folded before Flop (didn't bet)



PokerStars Zoom Hand #210171365793:  Hold'em No Limit (€0.01/€0.02) - 2020/03/15 19:57:51 CET [2020/03/15 14:57:51 ET]
Table 'Arneb' 6-max Seat #1 is the button
Seat 1: Luckers712 (€5.33 in chips)
Seat 2: bilboubou78 (€3.77 in chips)
Seat 3: DriztDUrden (€1.38 in chips)
Seat 4: PatBateman1975 (€2.03 in chips)
Seat 5: petitgold (€2 in chips)
Seat 6: Veesile (€8.24 in chips)
bilboubou78: posts small blind €0.01
DriztDUrden: posts big blind €0.02
*** HOLE CARDS ***
Dealt to Luckers712 [3d Ts]
PatBateman1975: folds
petitgold: folds
Veesile: folds
Luckers712: folds
bilboubou78: folds
Uncalled bet (€0.01) returned to DriztDUrden
DriztDUrden collected €0.02 from pot
DriztDUrden: doesn't show hand
*** SUMMARY ***
Total pot €0.02 | Rake €0
Seat 1: Luckers712 (button) folded before Flop (didn't bet)
Seat 2: bilboubou78 (small blind) folded before Flop
Seat 3: DriztDUrden (big blind) collected (€0.02)
Seat 4: PatBateman1975 folded before Flop (didn't bet)
Seat 5: petitgold folded before Flop (didn't bet)
Seat 6: Veesile folded before Flop (didn't bet)



PokerStars Zoom Hand #210171368389:  Hold'em No Limit (€0.01/€0.02) - 2020/03/15 19:57:56 CET [2020/03/15 14:57:56 ET]
Table 'Arneb' 6-max Seat #1 is the button
Seat 1: ERIZOCACHO (€2.37 in chips)
Seat 2: portu35 (€2.07 in chips)
Seat 3: Luckers712 (€5.33 in chips)
Seat 4: colgao87 (€3.60 in chips)
Seat 5: C@rlsberg (€1.12 in chips)
Seat 6: ElvasSniper (€2.09 in chips)
portu35: posts small blind €0.01
Luckers712: posts big blind €0.02
*** HOLE CARDS ***
Dealt to Luckers712 [Qc 7h]
colgao87: folds
C@rlsberg: raises €0.02 to €0.04
ElvasSniper: folds
ERIZOCACHO: folds
portu35: folds
Luckers712: calls €0.02
*** FLOP *** [Qd 4c Kd]
Luckers712: bets €0.05
C@rlsberg: calls €0.05
*** TURN *** [Qd 4c Kd] [7d]
Luckers712: bets €0.09
C@rlsberg: folds
Uncalled bet (€0.09) returned to Luckers712
Luckers712 collected €0.18 from pot
Luckers712: doesn't show hand
*** SUMMARY ***
Total pot €0.19 | Rake €0.01
Board [Qd 4c Kd 7d]
Seat 1: ERIZOCACHO (button) folded before Flop (didn't bet)
Seat 2: portu35 (small blind) folded before Flop
Seat 3: Luckers712 (big blind) collected (€0.18)
Seat 4: colgao87 folded before Flop (didn't bet)
Seat 5: C@rlsberg folded on the Turn
Seat 6: ElvasSniper folded before Flop (didn't bet)



PokerStars Zoom Hand #210171387262:  Hold'em No Limit (€0.01/€0.02) - 2020/03/15 19:58:26 CET [2020/03/15 14:58:26 ET]
Table 'Arneb' 6-max Seat #1 is the button
Seat 1: Ballagarey (€3.66 in chips)
Seat 2: Orisso30 (€2.28 in chips)
Seat 3: SonsOfFun (€4.03 in chips)
Seat 4: Kayfidze (€2.57 in chips)
Seat 5: BESTPLANET (€1.97 in chips)
Seat 6: Luckers712 (€5.42 in chips)
Orisso30: posts small blind €0.01
SonsOfFun: posts big blind €0.02
*** HOLE CARDS ***
Dealt to Luckers712 [Kd Js]
Kayfidze: folds
BESTPLANET: folds
Luckers712: raises €0.03 to €0.05
Ballagarey: folds
Orisso30: folds
SonsOfFun: calls €0.03
*** FLOP *** [Ad Ac 7d]
SonsOfFun: checks
Luckers712: bets €0.04
SonsOfFun: folds
Uncalled bet (€0.04) returned to Luckers712
Luckers712 collected €0.10 from pot
Luckers712: doesn't show hand
*** SUMMARY ***
Total pot €0.11 | Rake €0.01
Board [Ad Ac 7d]
Seat 1: Ballagarey (button) folded before Flop (didn't bet)
Seat 2: Orisso30 (small blind) folded before Flop
Seat 3: SonsOfFun (big blind) folded on the Flop
Seat 4: Kayfidze folded before Flop (didn't bet)
Seat 5: BESTPLANET folded before Flop (didn't bet)
Seat 6: Luckers712 collected (€0.10)



PokerStars Zoom Hand #210171415161:  Hold'em No Limit (€0.01/€0.02) - 2020/03/15 19:59:11 CET [2020/03/15 14:59:11 ET]
Table 'Arneb' 6-max Seat #1 is the button
Seat 1: Jou"Yonfa$" (€2 in chips)
Seat 2: C@rlsberg (€1 in chips)
Seat 3: 89JMML89 (€1.47 in chips)
Seat 4: amotinado85 (€2.75 in chips)
Seat 5: Luckers712 (€5.47 in chips)
Seat 6: Kayfidze (€6.14 in chips)
C@rlsberg: posts small blind €0.01
89JMML89: posts big blind €0.02
*** HOLE CARDS ***
Dealt to Luckers712 [5s 7h]
amotinado85: folds
Luckers712: folds
Kayfidze: folds
Jou"Yonfa$": folds
C@rlsberg: folds
Uncalled bet (€0.01) returned to 89JMML89
89JMML89 collected €0.02 from pot
89JMML89: doesn't show hand
*** SUMMARY ***
Total pot €0.02 | Rake €0
Seat 1: Jou"Yonfa$" (button) folded before Flop (didn't bet)
Seat 2: C@rlsberg (small blind) folded before Flop
Seat 3: 89JMML89 (big blind) collected (€0.02)
Seat 4: amotinado85 folded before Flop (didn't bet)
Seat 5: Luckers712 folded before Flop (didn't bet)
Seat 6: Kayfidze folded before Flop (didn't bet)



PokerStars Zoom Hand #210171417736:  Hold'em No Limit (€0.01/€0.02) - 2020/03/15 19:59:15 CET [2020/03/15 14:59:15 ET]
Table 'Arneb' 6-max Seat #1 is the button
Seat 1: BESTPLANET (€1.95 in chips)
Seat 2: melvacanutera (€3.81 in chips)
Seat 3: Rppopy (€3.50 in chips)
Seat 4: Luckers712 (€5.47 in chips)
Seat 5: ricmp (€2 in chips)
Seat 6: petitgold (€2 in chips)
melvacanutera: posts small blind €0.01
Rppopy: posts big blind €0.02
*** HOLE CARDS ***
Dealt to Luckers712 [Qs 8c]
Luckers712: folds
ricmp: folds
petitgold: folds
BESTPLANET: raises €0.08 to €0.10
melvacanutera: folds
Rppopy: folds
Uncalled bet (€0.08) returned to BESTPLANET
BESTPLANET collected €0.05 from pot
BESTPLANET: doesn't show hand
*** SUMMARY ***
Total pot €0.05 | Rake €0
Seat 1: BESTPLANET (button) collected (€0.05)
Seat 2: melvacanutera (small blind) folded before Flop
Seat 3: Rppopy (big blind) folded before Flop
Seat 4: Luckers712 folded before Flop (didn't bet)
Seat 5: ricmp folded before Flop (didn't bet)
Seat 6: petitgold folded before Flop (didn't bet)



PokerStars Zoom Hand #210171424212:  Hold'em No Limit (€0.01/€0.02) - 2020/03/15 19:59:25 CET [2020/03/15 14:59:25 ET]
Table 'Arneb' 6-max Seat #1 is the button
Seat 1: amotinado85 (€2.75 in chips)
Seat 2: marius-xsr (€2 in chips)
Seat 3: colgao87 (€3.04 in chips)
Seat 4: Veesile (€2.18 in chips)
Seat 5: pandemon (€1.60 in chips)
Seat 6: Luckers712 (€5.46 in chips)
marius-xsr: posts small blind €0.01
colgao87: posts big blind €0.02
*** HOLE CARDS ***
Dealt to Luckers712 [Jh Js]
Veesile: raises €0.03 to €0.05
pandemon: folds
Luckers712: calls €0.05
amotinado85: folds
marius-xsr: folds
colgao87: folds
*** FLOP *** [2h Kh As]
Veesile: checks
Luckers712: checks
*** TURN *** [2h Kh As] [4h]
Veesile: checks
Luckers712: checks
*** RIVER *** [2h Kh As 4h] [2c]
Veesile: checks
Luckers712: checks
*** SHOW DOWN ***
Veesile: shows [Qh Kd] (two pair, Kings and Deuces)
Luckers712: mucks hand
Veesile collected €0.12 from pot
*** SUMMARY ***
Total pot €0.13 | Rake €0.01
Board [2h Kh As 4h 2c]
Seat 1: amotinado85 (button) folded before Flop (didn't bet)
Seat 2: marius-xsr (small blind) folded before Flop
Seat 3: colgao87 (big blind) folded before Flop
Seat 4: Veesile showed [Qh Kd] and won (€0.12) with two pair, Kings and Deuces
Seat 5: pandemon folded before Flop (didn't bet)
Seat 6: Luckers712 mucked [Jh Js]



PokerStars Zoom Hand #210171421604:  Hold'em No Limit (€0.01/€0.02) - 2020/03/15 19:59:21 CET [2020/03/15 14:59:21 ET]
Table 'Arneb' 6-max Seat #1 is the button
Seat 1: BiggieShoot (€2.20 in chips)
Seat 2: Luckers712 (€5.47 in chips)
Seat 3: lunasa (€2.05 in chips)
Seat 4: Jou"Yonfa$" (€2 in chips)
Seat 5: bilboubou78 (€3.02 in chips)
Seat 6: andresrodr8 (€2 in chips)
Luckers712: posts small blind €0.01
lunasa: posts big blind €0.02
*** HOLE CARDS ***
Dealt to Luckers712 [9d 3s]
Jou"Yonfa$": folds
bilboubou78: folds
andresrodr8: raises €0.04 to €0.06
BiggieShoot: folds
Luckers712: folds
lunasa: raises €0.14 to €0.20
andresrodr8: raises €0.38 to €0.58
lunasa: raises €1.47 to €2.05 and is all-in
andresrodr8: calls €1.42 and is all-in
Uncalled bet (€0.05) returned to lunasa
*** FLOP *** [Ts Qd 4c]
*** TURN *** [Ts Qd 4c] [5s]
*** RIVER *** [Ts Qd 4c 5s] [6d]
*** SHOW DOWN ***
lunasa: shows [Kd Ks] (a pair of Kings)
andresrodr8: shows [Ac Ad] (a pair of Aces)
andresrodr8 collected €3.81 from pot
*** SUMMARY ***
Total pot €4.01 | Rake €0.20
Board [Ts Qd 4c 5s 6d]
Seat 1: BiggieShoot (button) folded before Flop (didn't bet)
Seat 2: Luckers712 (small blind) folded before Flop
Seat 3: lunasa (big blind) showed [Kd Ks] and lost with a pair of Kings
Seat 4: Jou"Yonfa$" folded before Flop (didn't bet)
Seat 5: bilboubou78 folded before Flop (didn't bet)
Seat 6: andresrodr8 showed [Ac Ad] and won (€3.81) with a pair of Aces



PokerStars Zoom Hand #210171447350:  Hold'em No Limit (€0.01/€0.02) - 2020/03/15 20:00:01 CET [2020/03/15 15:00:01 ET]
Table 'Arneb' 6-max Seat #1 is the button
Seat 1: Luckers712 (€5.41 in chips)
Seat 2: trakson (€2.72 in chips)
Seat 3: Capitan Aab (€2.34 in chips)
Seat 4: tatanekiki (€3.24 in chips)
Seat 5: Séneca Magic (€14.44 in chips)
Seat 6: ERIZOCACHO (€1.45 in chips)
trakson: posts small blind €0.01
Capitan Aab: posts big blind €0.02
*** HOLE CARDS ***
Dealt to Luckers712 [7h 4c]
tatanekiki: folds
Séneca Magic: folds
ERIZOCACHO: folds
Luckers712: folds
trakson: raises €0.04 to €0.06
Capitan Aab: folds
Uncalled bet (€0.04) returned to trakson
trakson collected €0.04 from pot
trakson: doesn't show hand
*** SUMMARY ***
Total pot €0.04 | Rake €0
Seat 1: Luckers712 (button) folded before Flop (didn't bet)
Seat 2: trakson (small blind) collected (€0.04)
Seat 3: Capitan Aab (big blind) folded before Flop
Seat 4: tatanekiki folded before Flop (didn't bet)
Seat 5: Séneca Magic folded before Flop (didn't bet)
Seat 6: ERIZOCACHO folded before Flop (didn't bet)



PokerStars Zoom Hand #210171444701:  Hold'em No Limit (€0.01/€0.02) - 2020/03/15 19:59:57 CET [2020/03/15 14:59:57 ET]
Table 'Arneb' 6-max Seat #1 is the button
Seat 1: marius-xsr (€2 in chips)
Seat 2: MaurusT (€1.95 in chips)
Seat 3: jl le canari (€2.12 in chips)
Seat 4: campanilla06 (€1.98 in chips)
Seat 5: Luckers712 (€5.41 in chips)
Seat 6: Veesile (€2.25 in chips)
MaurusT: posts small blind €0.01
jl le canari: posts big blind €0.02
*** HOLE CARDS ***
Dealt to Luckers712 [3d 7h]
campanilla06: folds
Luckers712: folds
Veesile: folds
marius-xsr: raises €0.03 to €0.05
MaurusT: folds
jl le canari: folds
Uncalled bet (€0.03) returned to marius-xsr
marius-xsr collected €0.05 from pot
marius-xsr: doesn't show hand
*** SUMMARY ***
Total pot €0.05 | Rake €0
Seat 1: marius-xsr (button) collected (€0.05)
Seat 2: MaurusT (small blind) folded before Flop
Seat 3: jl le canari (big blind) folded before Flop
Seat 4: campanilla06 folded before Flop (didn't bet)
Seat 5: Luckers712 folded before Flop (didn't bet)
Seat 6: Veesile folded before Flop (didn't bet)



PokerStars Zoom Hand #210171450632:  Hold'em No Limit (€0.01/€0.02) - 2020/03/15 20:00:06 CET [2020/03/15 15:00:06 ET]
Table 'Arneb' 6-max Seat #1 is the button
Seat 1: aportiquevoy (€1.63 in chips)
Seat 2: Kayfidze (€2.61 in chips)
Seat 3: Luckers712 (€5.41 in chips)
Seat 4: Vitorhcsousa (€3.15 in chips)
Seat 5: mahale81 (€1.89 in chips)
Seat 6: ALCINAPIN (€2 in chips)
Kayfidze: posts small blind €0.01
Luckers712: posts big blind €0.02
*** HOLE CARDS ***
Dealt to Luckers712 [As Ah]
Vitorhcsousa: folds
mahale81: folds
ALCINAPIN: raises €0.04 to €0.06
aportiquevoy: folds
Kayfidze: folds
Luckers712: raises €0.12 to €0.18
ALCINAPIN: folds
Uncalled bet (€0.12) returned to Luckers712
Luckers712 collected €0.13 from pot
Luckers712: doesn't show hand
*** SUMMARY ***
Total pot €0.13 | Rake €0
Seat 1: aportiquevoy (button) folded before Flop (didn't bet)
Seat 2: Kayfidze (small blind) folded before Flop
Seat 3: Luckers712 (big blind) collected (€0.13)
Seat 4: Vitorhcsousa folded before Flop (didn't bet)
Seat 5: mahale81 folded before Flop (didn't bet)
Seat 6: ALCINAPIN folded before Flop



PokerStars Zoom Hand #210171472665:  Hold'em No Limit (€0.01/€0.02) - 2020/03/15 20:00:38 CET [2020/03/15 15:00:38 ET]
Table 'Arneb' 6-max Seat #1 is the button
Seat 1: Jagf0010 (€2.19 in chips)
Seat 2: Luckers712 (€5.48 in chips)
Seat 3: Veesile (€2.35 in chips)
Seat 4: BiggieShoot (€4.12 in chips)
Seat 5: lusto09 (€9.43 in chips)
Seat 6: tatanekiki (€3.21 in chips)
Luckers712: posts small blind €0.01
Veesile: posts big blind €0.02
*** HOLE CARDS ***
Dealt to Luckers712 [9s 9d]
BiggieShoot: folds
lusto09: folds
tatanekiki: folds
Jagf0010: folds
Luckers712: raises €0.04 to €0.06
Veesile: folds
Uncalled bet (€0.04) returned to Luckers712
Luckers712 collected €0.04 from pot
Luckers712: doesn't show hand
*** SUMMARY ***
Total pot €0.04 | Rake €0
Seat 1: Jagf0010 (button) folded before Flop (didn't bet)
Seat 2: Luckers712 (small blind) collected (€0.04)
Seat 3: Veesile (big blind) folded before Flop
Seat 4: BiggieShoot folded before Flop (didn't bet)
Seat 5: lusto09 folded before Flop (didn't bet)
Seat 6: tatanekiki folded before Flop (didn't bet)



PokerStars Zoom Hand #210171482914:  Hold'em No Limit (€0.01/€0.02) - 2020/03/15 20:00:53 CET [2020/03/15 15:00:53 ET]
Table 'Arneb' 6-max Seat #1 is the button
Seat 1: unounoporfavor (€2.01 in chips)
Seat 2: Kayfidze (€2.58 in chips)
Seat 3: SaiyanSergio (€2.58 in chips)
Seat 4: Luckers712 (€5.50 in chips)
Seat 5: PrOdI11 (€2 in chips)
Seat 6: TXY151217 (€2.52 in chips)
Kayfidze: posts small blind €0.01
SaiyanSergio: posts big blind €0.02
*** HOLE CARDS ***
Dealt to Luckers712 [4h 9h]
Luckers712: folds
PrOdI11: folds
TXY151217: folds
unounoporfavor: raises €0.02 to €0.04
Kayfidze: folds
SaiyanSergio: folds
Uncalled bet (€0.02) returned to unounoporfavor
unounoporfavor collected €0.05 from pot
unounoporfavor: doesn't show hand
*** SUMMARY ***
Total pot €0.05 | Rake €0
Seat 1: unounoporfavor (button) collected (€0.05)
Seat 2: Kayfidze (small blind) folded before Flop
Seat 3: SaiyanSergio (big blind) folded before Flop
Seat 4: Luckers712 folded before Flop (didn't bet)
Seat 5: PrOdI11 folded before Flop (didn't bet)
Seat 6: TXY151217 folded before Flop (didn't bet)



PokerStars Zoom Hand #210171485733:  Hold'em No Limit (€0.01/€0.02) - 2020/03/15 20:00:57 CET [2020/03/15 15:00:57 ET]
Table 'Arneb' 6-max Seat #1 is the button
Seat 1: Luckers712 (€5.50 in chips)
Seat 2: LEDENT (€1.09 in chips)
Seat 3: mahale81 (€2.12 in chips)
Seat 4: bandittours (€4.30 in chips)
Seat 5: Shikamaru003 (€2 in chips)
Seat 6: BESTPLANET (€2.16 in chips)
LEDENT: posts small blind €0.01
mahale81: posts big blind €0.02
*** HOLE CARDS ***
Dealt to Luckers712 [7d Ah]
bandittours: folds
Shikamaru003: folds
BESTPLANET: folds
Luckers712: raises €0.03 to €0.05
LEDENT: folds
mahale81: raises €0.11 to €0.16
Luckers712: folds
Uncalled bet (€0.11) returned to mahale81
mahale81 collected €0.11 from pot
mahale81: doesn't show hand
*** SUMMARY ***
Total pot €0.11 | Rake €0
Seat 1: Luckers712 (button) folded before Flop
Seat 2: LEDENT (small blind) folded before Flop
Seat 3: mahale81 (big blind) collected (€0.11)
Seat 4: bandittours folded before Flop (didn't bet)
Seat 5: Shikamaru003 folded before Flop (didn't bet)
Seat 6: BESTPLANET folded before Flop (didn't bet)



PokerStars Zoom Hand #210171512329:  Hold'em No Limit (€0.01/€0.02) - 2020/03/15 20:01:34 CET [2020/03/15 15:01:34 ET]
Table 'Arneb' 6-max Seat #1 is the button
Seat 1: amotinado85 (€2.13 in chips)
Seat 2: Veesile (€2 in chips)
Seat 3: Shikamaru003 (€2 in chips)
Seat 4: Jagf0010 (€2 in chips)
Seat 5: Luckers712 (€5.45 in chips)
Seat 6: Viana1617 (€2.15 in chips)
Veesile: posts small blind €0.01
Shikamaru003: posts big blind €0.02
*** HOLE CARDS ***
Dealt to Luckers712 [9s 6h]
Jagf0010: folds
Luckers712: folds
Viana1617: raises €0.02 to €0.04
amotinado85: raises €0.14 to €0.18
Veesile: folds
Shikamaru003: folds
Viana1617: raises €1.97 to €2.15 and is all-in
amotinado85: calls €1.95 and is all-in
Uncalled bet (€0.02) returned to Viana1617
*** FLOP *** [4d 6c 3d]
*** TURN *** [4d 6c 3d] [2d]
*** RIVER *** [4d 6c 3d 2d] [7d]
*** SHOW DOWN ***
Viana1617: shows [Jc Ah] (high card Ace)
amotinado85: shows [Qs Qd] (a flush, Queen high)
amotinado85 collected €4.08 from pot
*** SUMMARY ***
Total pot €4.29 | Rake €0.21
Board [4d 6c 3d 2d 7d]
Seat 1: amotinado85 (button) showed [Qs Qd] and won (€4.08) with a flush, Queen high
Seat 2: Veesile (small blind) folded before Flop
Seat 3: Shikamaru003 (big blind) folded before Flop
Seat 4: Jagf0010 folded before Flop (didn't bet)
Seat 5: Luckers712 folded before Flop (didn't bet)
Seat 6: Viana1617 showed [Jc Ah] and lost with high card Ace



PokerStars Zoom Hand #210171508741:  Hold'em No Limit (€0.01/€0.02) - 2020/03/15 20:01:29 CET [2020/03/15 15:01:29 ET]
Table 'Arneb' 6-max Seat #1 is the button
Seat 1: Marlock10 (€3.75 in chips)
Seat 2: boalju (€1.93 in chips)
Seat 3: Vitorhcsousa (€4.69 in chips)
Seat 4: jacksparr485 (€3.10 in chips)
Seat 5: blucio99 (€2.32 in chips)
Seat 6: Luckers712 (€5.45 in chips)
boalju: posts small blind €0.01
Vitorhcsousa: posts big blind €0.02
*** HOLE CARDS ***
Dealt to Luckers712 [4d 2c]
jacksparr485: raises €0.04 to €0.06
blucio99: raises €0.12 to €0.18
Luckers712: folds
Marlock10: folds
boalju: folds
Vitorhcsousa: folds
jacksparr485: calls €0.12
*** FLOP *** [Qs 6s 2s]
jacksparr485: checks
blucio99: bets €0.19
jacksparr485: calls €0.19
*** TURN *** [Qs 6s 2s] [7s]
jacksparr485: checks
blucio99: checks
*** RIVER *** [Qs 6s 2s 7s] [Th]
jacksparr485: bets €0.62
blucio99: folds
Uncalled bet (€0.62) returned to jacksparr485
jacksparr485 collected €0.73 from pot
jacksparr485: doesn't show hand
*** SUMMARY ***
Total pot €0.77 | Rake €0.04
Board [Qs 6s 2s 7s Th]
Seat 1: Marlock10 (button) folded before Flop (didn't bet)
Seat 2: boalju (small blind) folded before Flop
Seat 3: Vitorhcsousa (big blind) folded before Flop
Seat 4: jacksparr485 collected (€0.73)
Seat 5: blucio99 folded on the River
Seat 6: Luckers712 folded before Flop (didn't bet)



PokerStars Zoom Hand #210171515388:  Hold'em No Limit (€0.01/€0.02) - 2020/03/15 20:01:37 CET [2020/03/15 15:01:37 ET]
Table 'Arneb' 6-max Seat #1 is the button
Seat 1: fality100 (€2.13 in chips)
Seat 2: DaniDekk (€2 in chips)
Seat 3: Luckers712 (€5.45 in chips)
Seat 4: Melsant8 (€2.06 in chips)
Seat 5: jonath760000 (€1.10 in chips)
Seat 6: Loulou62$157 (€1.06 in chips)
DaniDekk: posts small blind €0.01
Luckers712: posts big blind €0.02
*** HOLE CARDS ***
Dealt to Luckers712 [2s 6d]
Melsant8: folds
jonath760000: calls €0.02
Loulou62$157: calls €0.02
fality100: folds
DaniDekk: folds
Luckers712: checks
*** FLOP *** [Js 9c Tc]
Luckers712: checks
jonath760000: checks
Loulou62$157: checks
*** TURN *** [Js 9c Tc] [Kc]
Luckers712: checks
jonath760000: checks
Loulou62$157: checks
*** RIVER *** [Js 9c Tc Kc] [Ac]
Luckers712: checks
jonath760000: checks
Loulou62$157: bets €0.18
Luckers712: folds
jonath760000: folds
Uncalled bet (€0.18) returned to Loulou62$157
Loulou62$157 collected €0.07 from pot
Loulou62$157: doesn't show hand
*** SUMMARY ***
Total pot €0.07 | Rake €0
Board [Js 9c Tc Kc Ac]
Seat 1: fality100 (button) folded before Flop (didn't bet)
Seat 2: DaniDekk (small blind) folded before Flop
Seat 3: Luckers712 (big blind) folded on the River
Seat 4: Melsant8 folded before Flop (didn't bet)
Seat 5: jonath760000 folded on the River
Seat 6: Loulou62$157 collected (€0.07)



PokerStars Zoom Hand #210171554453:  Hold'em No Limit (€0.01/€0.02) - 2020/03/15 20:02:26 CET [2020/03/15 15:02:26 ET]
Table 'Arneb' 6-max Seat #1 is the button
Seat 1: petitgold (€3.89 in chips)
Seat 2: patriacs (€3.58 in chips)
Seat 3: KANDANSKY (€3.10 in chips)
Seat 4: KETETEMETO46 (€2.11 in chips)
Seat 5: GÜILLIUS (€1.93 in chips)
Seat 6: Luckers712 (€5.43 in chips)
patriacs: posts small blind €0.01
KANDANSKY: posts big blind €0.02
*** HOLE CARDS ***
Dealt to Luckers712 [Qc 8s]
KETETEMETO46: raises €0.02 to €0.04
GÜILLIUS: folds
Luckers712: folds
petitgold: folds
patriacs: folds
KANDANSKY: calls €0.02
*** FLOP *** [4s 4c Ks]
KANDANSKY: checks
KETETEMETO46: bets €0.10
KANDANSKY: folds
Uncalled bet (€0.10) returned to KETETEMETO46
KETETEMETO46 collected €0.09 from pot
KETETEMETO46: doesn't show hand
*** SUMMARY ***
Total pot €0.09 | Rake €0
Board [4s 4c Ks]
Seat 1: petitgold (button) folded before Flop (didn't bet)
Seat 2: patriacs (small blind) folded before Flop
Seat 3: KANDANSKY (big blind) folded on the Flop
Seat 4: KETETEMETO46 collected (€0.09)
Seat 5: GÜILLIUS folded before Flop (didn't bet)
Seat 6: Luckers712 folded before Flop (didn't bet)



PokerStars Zoom Hand #210171565503:  Hold'em No Limit (€0.01/€0.02) - 2020/03/15 20:02:37 CET [2020/03/15 15:02:37 ET]
Table 'Arneb' 6-max Seat #1 is the button
Seat 1: pabmesa (€1.81 in chips)
Seat 2: Urbina10 (€3.77 in chips)
Seat 3: DNooXLvv (€5.91 in chips)
Seat 4: ricmp (€4.28 in chips)
Seat 5: Luckers712 (€5.42 in chips)
Seat 6: ismasu (€3.77 in chips)
Urbina10: posts small blind €0.01
DNooXLvv: posts big blind €0.02
*** HOLE CARDS ***
Dealt to Luckers712 [Jh Ks]
ricmp: folds
Luckers712: raises €0.03 to €0.05
ismasu: folds
pabmesa: folds
Urbina10: folds
DNooXLvv: folds
Uncalled bet (€0.03) returned to Luckers712
Luckers712 collected €0.05 from pot
Luckers712: doesn't show hand
*** SUMMARY ***
Total pot €0.05 | Rake €0
Seat 1: pabmesa (button) folded before Flop (didn't bet)
Seat 2: Urbina10 (small blind) folded before Flop
Seat 3: DNooXLvv (big blind) folded before Flop
Seat 4: ricmp folded before Flop (didn't bet)
Seat 5: Luckers712 collected (€0.05)
Seat 6: ismasu folded before Flop (didn't bet)



PokerStars Zoom Hand #210171560940:  Hold'em No Limit (€0.01/€0.02) - 2020/03/15 20:02:33 CET [2020/03/15 15:02:33 ET]
Table 'Arneb' 6-max Seat #1 is the button
Seat 1: DriztDUrden (€1.26 in chips)
Seat 2: Luckers712 (€5.43 in chips)
Seat 3: pepedopacio (€2 in chips)
Seat 4: Chunclis (€0.91 in chips)
Seat 5: mahale81 (€2.14 in chips)
Seat 6: PrOdI11 (€2.03 in chips)
Luckers712: posts small blind €0.01
pepedopacio: posts big blind €0.02
*** HOLE CARDS ***
Dealt to Luckers712 [5s 7c]
Chunclis: raises €0.04 to €0.06
mahale81: folds
PrOdI11: folds
DriztDUrden: raises €0.15 to €0.21
Luckers712: folds
pepedopacio: folds
Chunclis: raises €0.70 to €0.91 and is all-in
DriztDUrden: folds
Uncalled bet (€0.70) returned to Chunclis
Chunclis collected €0.45 from pot
Chunclis: doesn't show hand
*** SUMMARY ***
Total pot €0.45 | Rake €0
Seat 1: DriztDUrden (button) folded before Flop
Seat 2: Luckers712 (small blind) folded before Flop
Seat 3: pepedopacio (big blind) folded before Flop
Seat 4: Chunclis collected (€0.45)
Seat 5: mahale81 folded before Flop (didn't bet)
Seat 6: PrOdI11 folded before Flop (didn't bet)



PokerStars Zoom Hand #210171588261:  Hold'em No Limit (€0.01/€0.02) - 2020/03/15 20:03:02 CET [2020/03/15 15:03:02 ET]
Table 'Arneb' 6-max Seat #1 is the button
Seat 1: dealercost (€2.65 in chips)
Seat 2: KANDANSKY (€3.06 in chips)
Seat 3: Jasonangel51 (€0.96 in chips)
Seat 4: Luckers712 (€5.45 in chips)
Seat 5: kingdjass972 (€2.01 in chips)
Seat 6: amotinado85 (€4.05 in chips)
KANDANSKY: posts small blind €0.01
Jasonangel51: posts big blind €0.02
*** HOLE CARDS ***
Dealt to Luckers712 [Ad Qc]
Luckers712: raises €0.04 to €0.06
kingdjass972: folds
amotinado85: folds
dealercost: calls €0.06
KANDANSKY: folds
Jasonangel51: folds
*** FLOP *** [3s 6d Kd]
Luckers712: checks
dealercost: checks
*** TURN *** [3s 6d Kd] [5d]
Luckers712: checks
dealercost: checks
*** RIVER *** [3s 6d Kd 5d] [As]
Luckers712: bets €0.17
dealercost: folds
Uncalled bet (€0.17) returned to Luckers712
Luckers712 collected €0.14 from pot
Luckers712: doesn't show hand
*** SUMMARY ***
Total pot €0.15 | Rake €0.01
Board [3s 6d Kd 5d As]
Seat 1: dealercost (button) folded on the River
Seat 2: KANDANSKY (small blind) folded before Flop
Seat 3: Jasonangel51 (big blind) folded before Flop
Seat 4: Luckers712 collected (€0.14)
Seat 5: kingdjass972 folded before Flop (didn't bet)
Seat 6: amotinado85 folded before Flop (didn't bet)



PokerStars Zoom Hand #210171642208:  Hold'em No Limit (€0.01/€0.02) - 2020/03/15 20:04:00 CET [2020/03/15 15:04:00 ET]
Table 'Arneb' 6-max Seat #1 is the button
Seat 1: PrOdI11 (€5.64 in chips)
Seat 2: ricmp (€2.01 in chips)
Seat 3: Luckers712 (€5.53 in chips)
Seat 4: mekekatorce (€2.06 in chips)
Seat 5: Vitorhcsousa (€2 in chips)
Seat 6: Chunclis (€0.85 in chips)
ricmp: posts small blind €0.01
Luckers712: posts big blind €0.02
*** HOLE CARDS ***
Dealt to Luckers712 [Th 4c]
mekekatorce: raises €0.04 to €0.06
Vitorhcsousa: folds
Chunclis: folds
PrOdI11: folds
ricmp: folds
Luckers712: folds
Uncalled bet (€0.04) returned to mekekatorce
mekekatorce collected €0.05 from pot
mekekatorce: doesn't show hand
*** SUMMARY ***
Total pot €0.05 | Rake €0
Seat 1: PrOdI11 (button) folded before Flop (didn't bet)
Seat 2: ricmp (small blind) folded before Flop
Seat 3: Luckers712 (big blind) folded before Flop
Seat 4: mekekatorce collected (€0.05)
Seat 5: Vitorhcsousa folded before Flop (didn't bet)
Seat 6: Chunclis folded before Flop (didn't bet)



PokerStars Zoom Hand #210171646891:  Hold'em No Limit (€0.01/€0.02) - 2020/03/15 20:04:05 CET [2020/03/15 15:04:05 ET]
Table 'Arneb' 6-max Seat #1 is the button
Seat 1: Luckers712 (€5.51 in chips)
Seat 2: Jagf0010 (€2.87 in chips)
Seat 3: elijeni1323 (€1.08 in chips)
Seat 4: manusport (€2.05 in chips)
Seat 5: Chunclis (€0.85 in chips)
Seat 6: Vitorhcsousa (€2 in chips)
Jagf0010: posts small blind €0.01
elijeni1323: posts big blind €0.02
*** HOLE CARDS ***
Dealt to Luckers712 [3d Jc]
manusport: folds
Chunclis: raises €0.04 to €0.06
Vitorhcsousa: calls €0.06
Luckers712: folds
Jagf0010: folds
elijeni1323: folds
*** FLOP *** [Kh Kd Tc]
Chunclis: bets €0.07
Vitorhcsousa: folds
Uncalled bet (€0.07) returned to Chunclis
Chunclis collected €0.14 from pot
Chunclis: doesn't show hand
*** SUMMARY ***
Total pot €0.15 | Rake €0.01
Board [Kh Kd Tc]
Seat 1: Luckers712 (button) folded before Flop (didn't bet)
Seat 2: Jagf0010 (small blind) folded before Flop
Seat 3: elijeni1323 (big blind) folded before Flop
Seat 4: manusport folded before Flop (didn't bet)
Seat 5: Chunclis collected (€0.14)
Seat 6: Vitorhcsousa folded on the Flop



PokerStars Zoom Hand #210171650807:  Hold'em No Limit (€0.01/€0.02) - 2020/03/15 20:04:09 CET [2020/03/15 15:04:09 ET]
Table 'Arneb' 6-max Seat #1 is the button
Seat 1: cocololo91 (€1.98 in chips)
Seat 2: ipriego123 (€1.06 in chips)
Seat 3: jonath760000 (€1.18 in chips)
Seat 4: SonsOfFun (€4.36 in chips)
Seat 5: MDKristian (€1.77 in chips)
Seat 6: Luckers712 (€5.51 in chips)
ipriego123: posts small blind €0.01
jonath760000: posts big blind €0.02
*** HOLE CARDS ***
Dealt to Luckers712 [Ks Kc]
SonsOfFun: folds
MDKristian: folds
Luckers712: raises €0.03 to €0.05
cocololo91: folds
ipriego123: calls €0.04
jonath760000: calls €0.03
*** FLOP *** [3d 7c Qs]
ipriego123: bets €0.08
jonath760000: raises €0.08 to €0.16
Luckers712: raises €0.08 to €0.24
ipriego123: folds
jonath760000: raises €0.89 to €1.13 and is all-in
Luckers712: calls €0.89
*** TURN *** [3d 7c Qs] [Kd]
*** RIVER *** [3d 7c Qs Kd] [Js]
*** SHOW DOWN ***
jonath760000: shows [7s Qd] (two pair, Queens and Sevens)
Luckers712: shows [Ks Kc] (three of a kind, Kings)
Luckers712 collected €2.37 from pot
*** SUMMARY ***
Total pot €2.49 | Rake €0.12
Board [3d 7c Qs Kd Js]
Seat 1: cocololo91 (button) folded before Flop (didn't bet)
Seat 2: ipriego123 (small blind) folded on the Flop
Seat 3: jonath760000 (big blind) showed [7s Qd] and lost with two pair, Queens and Sevens
Seat 4: SonsOfFun folded before Flop (didn't bet)
Seat 5: MDKristian folded before Flop (didn't bet)
Seat 6: Luckers712 showed [Ks Kc] and won (€2.37) with three of a kind, Kings



PokerStars Zoom Hand #210171700075:  Hold'em No Limit (€0.01/€0.02) - 2020/03/15 20:05:01 CET [2020/03/15 15:05:01 ET]
Table 'Arneb' 6-max Seat #1 is the button
Seat 1: unounoporfavor (€10.65 in chips)
Seat 2: Luckers712 (€6.70 in chips)
Seat 3: BESTPLANET (€2.76 in chips)
Seat 4: Veesile (€2.03 in chips)
Seat 5: ismasu (€4.71 in chips)
Seat 6: Franç@ (€7.83 in chips)
Luckers712: posts small blind €0.01
BESTPLANET: posts big blind €0.02
*** HOLE CARDS ***
Dealt to Luckers712 [Qd 7d]
Veesile: folds
ismasu: folds
Franç@: folds
unounoporfavor: raises €0.02 to €0.04
Luckers712: calls €0.03
BESTPLANET: folds
*** FLOP *** [8c 7h Td]
Luckers712: bets €0.04
unounoporfavor: calls €0.04
*** TURN *** [8c 7h Td] [Ks]
Luckers712: checks
unounoporfavor: bets €0.06
Luckers712: folds
Uncalled bet (€0.06) returned to unounoporfavor
unounoporfavor collected €0.17 from pot
unounoporfavor: doesn't show hand
*** SUMMARY ***
Total pot €0.18 | Rake €0.01
Board [8c 7h Td Ks]
Seat 1: unounoporfavor (button) collected (€0.17)
Seat 2: Luckers712 (small blind) folded on the Turn
Seat 3: BESTPLANET (big blind) folded before Flop
Seat 4: Veesile folded before Flop (didn't bet)
Seat 5: ismasu folded before Flop (didn't bet)
Seat 6: Franç@ folded before Flop (didn't bet)



PokerStars Zoom Hand #210171748650:  Hold'em No Limit (€0.01/€0.02) - 2020/03/15 20:05:51 CET [2020/03/15 15:05:51 ET]
Table 'Arneb' 6-max Seat #1 is the button
Seat 1: TheKing11597 (€2.65 in chips)
Seat 2: KETETEMETO46 (€1.92 in chips)
Seat 3: Orisso30 (€2 in chips)
Seat 4: Rabesss (€1.37 in chips)
Seat 5: Luckers712 (€6.62 in chips)
Seat 6: pepedopacio (€2.41 in chips)
KETETEMETO46: posts small blind €0.01
Orisso30: posts big blind €0.02
*** HOLE CARDS ***
Dealt to Luckers712 [9s Ts]
Rabesss: folds
Luckers712: raises €0.03 to €0.05
pepedopacio: calls €0.05
TheKing11597: folds
KETETEMETO46: folds
Orisso30: folds
*** FLOP *** [Ad Ks 3h]
Luckers712: bets €0.06
pepedopacio: calls €0.06
*** TURN *** [Ad Ks 3h] [Tc]
Luckers712: bets €0.06
pepedopacio: calls €0.06
*** RIVER *** [Ad Ks 3h Tc] [Qh]
Luckers712: checks
pepedopacio: bets €0.12
Luckers712: folds
Uncalled bet (€0.12) returned to pepedopacio
pepedopacio collected €0.35 from pot
pepedopacio: doesn't show hand
*** SUMMARY ***
Total pot €0.37 | Rake €0.02
Board [Ad Ks 3h Tc Qh]
Seat 1: TheKing11597 (button) folded before Flop (didn't bet)
Seat 2: KETETEMETO46 (small blind) folded before Flop
Seat 3: Orisso30 (big blind) folded before Flop
Seat 4: Rabesss folded before Flop (didn't bet)
Seat 5: Luckers712 folded on the River
Seat 6: pepedopacio collected (€0.35)



PokerStars Zoom Hand #210171807025:  Hold'em No Limit (€0.01/€0.02) - 2020/03/15 20:06:51 CET [2020/03/15 15:06:51 ET]
Table 'Arneb' 6-max Seat #1 is the button
Seat 1: Luckers712 (€6.45 in chips)
Seat 2: manusport (€2.04 in chips)
Seat 3: ALCINAPIN (€2 in chips)
Seat 4: Kayfidze (€3.99 in chips)
Seat 5: lunasa (€2.07 in chips)
Seat 6: Shikamaru003 (€2.17 in chips)
manusport: posts small blind €0.01
ALCINAPIN: posts big blind €0.02
*** HOLE CARDS ***
Dealt to Luckers712 [Jd 6h]
Kayfidze has timed out
Kayfidze: folds
lunasa: folds
Shikamaru003: folds
Luckers712: folds
manusport: raises €0.04 to €0.06
ALCINAPIN: folds
Uncalled bet (€0.04) returned to manusport
manusport collected €0.04 from pot
manusport: doesn't show hand
*** SUMMARY ***
Total pot €0.04 | Rake €0
Seat 1: Luckers712 (button) folded before Flop (didn't bet)
Seat 2: manusport (small blind) collected (€0.04)
Seat 3: ALCINAPIN (big blind) folded before Flop
Seat 4: Kayfidze folded before Flop (didn't bet)
Seat 5: lunasa folded before Flop (didn't bet)
Seat 6: Shikamaru003 folded before Flop (didn't bet)



PokerStars Zoom Hand #210171811856:  Hold'em No Limit (€0.01/€0.02) - 2020/03/15 20:06:56 CET [2020/03/15 15:06:56 ET]
Table 'Arneb' 6-max Seat #1 is the button
Seat 1: slof14 (€1.05 in chips)
Seat 2: Chunclis (€1.07 in chips)
Seat 3: unounoporfavor (€2.37 in chips)
Seat 4: Luckers712 (€6.45 in chips)
Seat 5: walowz (€3.05 in chips)
Seat 6: thehunterfox (€2.57 in chips)
Chunclis: posts small blind €0.01
unounoporfavor: posts big blind €0.02
*** HOLE CARDS ***
Dealt to Luckers712 [2c 4d]
Luckers712: folds
walowz: raises €0.04 to €0.06
thehunterfox: folds
slof14: folds
Chunclis: folds
unounoporfavor: folds
Uncalled bet (€0.04) returned to walowz
walowz collected €0.05 from pot
walowz: doesn't show hand
*** SUMMARY ***
Total pot €0.05 | Rake €0
Seat 1: slof14 (button) folded before Flop (didn't bet)
Seat 2: Chunclis (small blind) folded before Flop
Seat 3: unounoporfavor (big blind) folded before Flop
Seat 4: Luckers712 folded before Flop (didn't bet)
Seat 5: walowz collected (€0.05)
Seat 6: thehunterfox folded before Flop (didn't bet)



PokerStars Zoom Hand #210171815683:  Hold'em No Limit (€0.01/€0.02) - 2020/03/15 20:07:00 CET [2020/03/15 15:07:00 ET]
Table 'Arneb' 6-max Seat #1 is the button
Seat 1: pepemaria11 (€0.27 in chips)
Seat 2: Luckers712 (€6.45 in chips)
Seat 3: jorge2626 (€4.12 in chips)
Seat 4: lusto09 (€8.47 in chips)
Seat 5: AAotearoa (€7.10 in chips)
Seat 6: Ðynamic7 (€2 in chips)
Luckers712: posts small blind €0.01
jorge2626: posts big blind €0.02
*** HOLE CARDS ***
Dealt to Luckers712 [9d Jc]
lusto09: folds
AAotearoa: folds
Ðynamic7: raises €0.04 to €0.06
pepemaria11: folds
Luckers712: folds
jorge2626: folds
Uncalled bet (€0.04) returned to Ðynamic7
Ðynamic7 collected €0.05 from pot
Ðynamic7: doesn't show hand
*** SUMMARY ***
Total pot €0.05 | Rake €0
Seat 1: pepemaria11 (button) folded before Flop (didn't bet)
Seat 2: Luckers712 (small blind) folded before Flop
Seat 3: jorge2626 (big blind) folded before Flop
Seat 4: lusto09 folded before Flop (didn't bet)
Seat 5: AAotearoa folded before Flop (didn't bet)
Seat 6: Ðynamic7 collected (€0.05)



PokerStars Zoom Hand #210173200587:  Hold'em No Limit (€0.01/€0.02) - 2020/03/15 20:30:43 CET [2020/03/15 15:30:43 ET]
Table 'Arneb' 6-max Seat #1 is the button
Seat 1: elkaiser605 (€2.25 in chips)
Seat 2: Rppopy (€4.95 in chips)
Seat 3: Luckers712 (€6.44 in chips)
Seat 4: loudydrix (€0.33 in chips)
Seat 5: Melsant8 (€5.04 in chips)
Seat 6: $TRONG MONEY (€1.76 in chips)
Rppopy: posts small blind €0.01
Luckers712: posts big blind €0.02
*** HOLE CARDS ***
Dealt to Luckers712 [2h 3s]
loudydrix: calls €0.02
Melsant8: folds
$TRONG MONEY: folds
elkaiser605: folds
Rppopy: folds
Luckers712: checks
*** FLOP *** [2s 7d 8c]
Luckers712: checks
loudydrix: checks
*** TURN *** [2s 7d 8c] [Ks]
Luckers712: checks
loudydrix: checks
*** RIVER *** [2s 7d 8c Ks] [8d]
Luckers712: checks
loudydrix: checks
*** SHOW DOWN ***
Luckers712: shows [2h 3s] (two pair, Eights and Deuces)
loudydrix: mucks hand
Luckers712 collected €0.05 from pot
*** SUMMARY ***
Total pot €0.05 | Rake €0
Board [2s 7d 8c Ks 8d]
Seat 1: elkaiser605 (button) folded before Flop (didn't bet)
Seat 2: Rppopy (small blind) folded before Flop
Seat 3: Luckers712 (big blind) showed [2h 3s] and won (€0.05) with two pair, Eights and Deuces
Seat 4: loudydrix mucked [Ah Qs]
Seat 5: Melsant8 folded before Flop (didn't bet)
Seat 6: $TRONG MONEY folded before Flop (didn't bet)



PokerStars Zoom Hand #210173232816:  Hold'em No Limit (€0.01/€0.02) - 2020/03/15 20:31:16 CET [2020/03/15 15:31:16 ET]
Table 'Arneb' 6-max Seat #1 is the button
Seat 1: Luckers712 (€6.47 in chips)
Seat 2: mekekatorce (€2 in chips)
Seat 3: colgao87 (€3.99 in chips)
Seat 4: xNYCTALUSx (€1 in chips)
Seat 5: maritz12 (€2.03 in chips)
Seat 6: ElvasSniper (€3.31 in chips)
mekekatorce: posts small blind €0.01
colgao87: posts big blind €0.02
*** HOLE CARDS ***
Dealt to Luckers712 [Jh 8s]
xNYCTALUSx: folds
maritz12: raises €0.04 to €0.06
ElvasSniper: folds
Luckers712: folds
mekekatorce: raises €0.20 to €0.26
colgao87: folds
maritz12: raises €0.28 to €0.54
mekekatorce: raises €1.46 to €2 and is all-in
maritz12: calls €1.46
*** FLOP *** [6h Qc Ks]
*** TURN *** [6h Qc Ks] [4c]
*** RIVER *** [6h Qc Ks 4c] [8h]
*** SHOW DOWN ***
mekekatorce: shows [Kc As] (a pair of Kings)
maritz12: shows [Ah Ac] (a pair of Aces)
maritz12 collected €3.82 from pot
*** SUMMARY ***
Total pot €4.02 | Rake €0.20
Board [6h Qc Ks 4c 8h]
Seat 1: Luckers712 (button) folded before Flop (didn't bet)
Seat 2: mekekatorce (small blind) showed [Kc As] and lost with a pair of Kings
Seat 3: colgao87 (big blind) folded before Flop
Seat 4: xNYCTALUSx folded before Flop (didn't bet)
Seat 5: maritz12 showed [Ah Ac] and won (€3.82) with a pair of Aces
Seat 6: ElvasSniper folded before Flop (didn't bet)



PokerStars Zoom Hand #210173242523:  Hold'em No Limit (€0.01/€0.02) - 2020/03/15 20:31:26 CET [2020/03/15 15:31:26 ET]
Table 'Arneb' 6-max Seat #1 is the button
Seat 1: Comino79 (€1.71 in chips)
Seat 2: Luckers712 (€6.47 in chips)
Seat 3: Sespir (€2.03 in chips)
Seat 4: Vitorhcsousa (€2.72 in chips)
Seat 5: JeromeMolina (€2.14 in chips)
Seat 6: LuisMatos27 (€2.77 in chips)
Luckers712: posts small blind €0.01
Sespir: posts big blind €0.02
*** HOLE CARDS ***
Dealt to Luckers712 [6c 8c]
Vitorhcsousa: folds
JeromeMolina: raises €0.02 to €0.04
LuisMatos27: calls €0.04
Comino79: folds
Luckers712: calls €0.03
Sespir: folds
*** FLOP *** [3c 8h Qs]
Luckers712: checks
JeromeMolina: checks
LuisMatos27: bets €0.08
Luckers712: folds
JeromeMolina: folds
Uncalled bet (€0.08) returned to LuisMatos27
LuisMatos27 collected €0.13 from pot
LuisMatos27: doesn't show hand
*** SUMMARY ***
Total pot €0.14 | Rake €0.01
Board [3c 8h Qs]
Seat 1: Comino79 (button) folded before Flop (didn't bet)
Seat 2: Luckers712 (small blind) folded on the Flop
Seat 3: Sespir (big blind) folded before Flop
Seat 4: Vitorhcsousa folded before Flop (didn't bet)
Seat 5: JeromeMolina folded on the Flop
Seat 6: LuisMatos27 collected (€0.13)



PokerStars Zoom Hand #210173290001:  Hold'em No Limit (€0.01/€0.02) - 2020/03/15 20:32:12 CET [2020/03/15 15:32:12 ET]
Table 'Arneb' 6-max Seat #1 is the button
Seat 1: elijeni1323 (€0.92 in chips)
Seat 2: Jans2011 (€4.09 in chips)
Seat 3: KALASH71 (€2.48 in chips)
Seat 4: Ðynamic7 (€5.10 in chips)
Seat 5: agus166 (€3.73 in chips)
Seat 6: Luckers712 (€6.43 in chips)
Jans2011: posts small blind €0.01
KALASH71: posts big blind €0.02
*** HOLE CARDS ***
Dealt to Luckers712 [4c 2s]
Ðynamic7: folds
agus166: folds
Luckers712: folds
elijeni1323: calls €0.02
Jans2011: raises €0.08 to €0.10
KALASH71: folds
elijeni1323: calls €0.08
*** FLOP *** [Js 6c Tc]
Jans2011: bets €0.12
elijeni1323: folds
Uncalled bet (€0.12) returned to Jans2011
Jans2011 collected €0.21 from pot
Jans2011: doesn't show hand
*** SUMMARY ***
Total pot €0.22 | Rake €0.01
Board [Js 6c Tc]
Seat 1: elijeni1323 (button) folded on the Flop
Seat 2: Jans2011 (small blind) collected (€0.21)
Seat 3: KALASH71 (big blind) folded before Flop
Seat 4: Ðynamic7 folded before Flop (didn't bet)
Seat 5: agus166 folded before Flop (didn't bet)
Seat 6: Luckers712 folded before Flop (didn't bet)



PokerStars Zoom Hand #210173293800:  Hold'em No Limit (€0.01/€0.02) - 2020/03/15 20:32:16 CET [2020/03/15 15:32:16 ET]
Table 'Arneb' 6-max Seat #1 is the button
Seat 1: cañon000 (€2.06 in chips)
Seat 2: Munrra10 (€2.08 in chips)
Seat 3: aleixeSp (€1.03 in chips)
Seat 4: 66ocb (€3.22 in chips)
Seat 5: Luckers712 (€6.43 in chips)
Seat 6: trilita1952 (€0.93 in chips)
Munrra10: posts small blind €0.01
aleixeSp: posts big blind €0.02
*** HOLE CARDS ***
Dealt to Luckers712 [8d 6s]
66ocb: calls €0.02
Luckers712: folds
trilita1952: folds
cañon000: calls €0.02
Munrra10: raises €0.08 to €0.10
aleixeSp: folds
66ocb: calls €0.08
cañon000: calls €0.08
*** FLOP *** [Ad 6d 2s]
Munrra10: checks
66ocb: checks
cañon000: checks
*** TURN *** [Ad 6d 2s] [4d]
Munrra10: checks
66ocb: bets €0.06
cañon000: folds
Munrra10: calls €0.06
*** RIVER *** [Ad 6d 2s 4d] [Js]
Munrra10: checks
66ocb: bets €0.10
Munrra10: calls €0.10
*** SHOW DOWN ***
66ocb: shows [9h 7h] (high card Ace)
Munrra10: shows [Ac Jc] (two pair, Aces and Jacks)
Munrra10 collected €0.61 from pot
*** SUMMARY ***
Total pot €0.64 | Rake €0.03
Board [Ad 6d 2s 4d Js]
Seat 1: cañon000 (button) folded on the Turn
Seat 2: Munrra10 (small blind) showed [Ac Jc] and won (€0.61) with two pair, Aces and Jacks
Seat 3: aleixeSp (big blind) folded before Flop
Seat 4: 66ocb showed [9h 7h] and lost with high card Ace
Seat 5: Luckers712 folded before Flop (didn't bet)
Seat 6: trilita1952 folded before Flop (didn't bet)



PokerStars Zoom Hand #210173297662:  Hold'em No Limit (€0.01/€0.02) - 2020/03/15 20:32:20 CET [2020/03/15 15:32:20 ET]
Table 'Arneb' 6-max Seat #1 is the button
Seat 1: unounoporfavor (€2.08 in chips)
Seat 2: jl le canari (€1.73 in chips)
Seat 3: Ðynamic7 (€5.10 in chips)
Seat 4: jacksparr485 (€2 in chips)
Seat 5: kisko87 (€2.08 in chips)
Seat 6: Luckers712 (€6.43 in chips)
jl le canari: posts small blind €0.01
Ðynamic7: posts big blind €0.02
*** HOLE CARDS ***
Dealt to Luckers712 [5s 4s]
jacksparr485: folds
kisko87: folds
Luckers712: raises €0.03 to €0.05
unounoporfavor: folds
jl le canari: folds
Ðynamic7: calls €0.03
*** FLOP *** [Tc 9c Kd]
Ðynamic7: checks
Luckers712: bets €0.05
Ðynamic7: calls €0.05
*** TURN *** [Tc 9c Kd] [Js]
Ðynamic7: checks
Luckers712: checks
*** RIVER *** [Tc 9c Kd Js] [8s]
Ðynamic7: checks
Luckers712: checks
*** SHOW DOWN ***
Ðynamic7: shows [7s Kh] (a straight, Seven to Jack)
Luckers712: mucks hand
Ðynamic7 collected €0.20 from pot
*** SUMMARY ***
Total pot €0.21 | Rake €0.01
Board [Tc 9c Kd Js 8s]
Seat 1: unounoporfavor (button) folded before Flop (didn't bet)
Seat 2: jl le canari (small blind) folded before Flop
Seat 3: Ðynamic7 (big blind) showed [7s Kh] and won (€0.20) with a straight, Seven to Jack
Seat 4: jacksparr485 folded before Flop (didn't bet)
Seat 5: kisko87 folded before Flop (didn't bet)
Seat 6: Luckers712 mucked [5s 4s]



PokerStars Zoom Hand #210173352580:  Hold'em No Limit (€0.01/€0.02) - 2020/03/15 20:33:17 CET [2020/03/15 15:33:17 ET]
Table 'Arneb' 6-max Seat #1 is the button
Seat 1: Pancorb (€2.10 in chips)
Seat 2: Luckers712 (€6.33 in chips)
Seat 3: maritz12 (€3.90 in chips)
Seat 4: jacksparr485 (€2 in chips)
Seat 5: gusfreitas (€3.71 in chips)
Seat 6: BiggieShoot (€5.97 in chips)
Luckers712: posts small blind €0.01
maritz12: posts big blind €0.02
*** HOLE CARDS ***
Dealt to Luckers712 [8s 7c]
jacksparr485: folds
gusfreitas: folds
BiggieShoot: folds
Pancorb: folds
Luckers712: folds
Uncalled bet (€0.01) returned to maritz12
maritz12 collected €0.02 from pot
maritz12: doesn't show hand
*** SUMMARY ***
Total pot €0.02 | Rake €0
Seat 1: Pancorb (button) folded before Flop (didn't bet)
Seat 2: Luckers712 (small blind) folded before Flop
Seat 3: maritz12 (big blind) collected (€0.02)
Seat 4: jacksparr485 folded before Flop (didn't bet)
Seat 5: gusfreitas folded before Flop (didn't bet)
Seat 6: BiggieShoot folded before Flop (didn't bet)



PokerStars Zoom Hand #210173356567:  Hold'em No Limit (€0.01/€0.02) - 2020/03/15 20:33:21 CET [2020/03/15 15:33:21 ET]
Table 'Arneb' 6-max Seat #1 is the button
Seat 1: Robersaz (€7.40 in chips)
Seat 2: Veesile (€8.88 in chips)
Seat 3: Luckers712 (€6.32 in chips)
Seat 4: levdudinES (€1.80 in chips)
Seat 5: Aleksifr (€4 in chips)
Seat 6: Ðynamic7 (€5.20 in chips)
Veesile: posts small blind €0.01
Luckers712: posts big blind €0.02
*** HOLE CARDS ***
Dealt to Luckers712 [9c 5h]
levdudinES: folds
Aleksifr: folds
Ðynamic7: raises €0.04 to €0.06
Robersaz: folds
Veesile: folds
Luckers712: folds
Uncalled bet (€0.04) returned to Ðynamic7
Ðynamic7 collected €0.05 from pot
Ðynamic7: doesn't show hand
*** SUMMARY ***
Total pot €0.05 | Rake €0
Seat 1: Robersaz (button) folded before Flop (didn't bet)
Seat 2: Veesile (small blind) folded before Flop
Seat 3: Luckers712 (big blind) folded before Flop
Seat 4: levdudinES folded before Flop (didn't bet)
Seat 5: Aleksifr folded before Flop (didn't bet)
Seat 6: Ðynamic7 collected (€0.05)



PokerStars Zoom Hand #210173366254:  Hold'em No Limit (€0.01/€0.02) - 2020/03/15 20:33:31 CET [2020/03/15 15:33:31 ET]
Table 'Arneb' 6-max Seat #1 is the button
Seat 1: Luckers712 (€6.30 in chips)
Seat 2: ALCINAPIN (€2.03 in chips)
Seat 3: lunasa (€2.49 in chips)
Seat 4: ricmp (€5.06 in chips)
Seat 5: maritz12 (€2.04 in chips)
Seat 6: PrOdI11 (€13.55 in chips)
ALCINAPIN: posts small blind €0.01
lunasa: posts big blind €0.02
*** HOLE CARDS ***
Dealt to Luckers712 [Js 5d]
ricmp: raises €0.04 to €0.06
maritz12: folds
PrOdI11: folds
Luckers712: folds
ALCINAPIN: folds
lunasa: folds
Uncalled bet (€0.04) returned to ricmp
ricmp collected €0.05 from pot
ricmp: doesn't show hand
*** SUMMARY ***
Total pot €0.05 | Rake €0
Seat 1: Luckers712 (button) folded before Flop (didn't bet)
Seat 2: ALCINAPIN (small blind) folded before Flop
Seat 3: lunasa (big blind) folded before Flop
Seat 4: ricmp collected (€0.05)
Seat 5: maritz12 folded before Flop (didn't bet)
Seat 6: PrOdI11 folded before Flop (didn't bet)



PokerStars Zoom Hand #210173370077:  Hold'em No Limit (€0.01/€0.02) - 2020/03/15 20:33:35 CET [2020/03/15 15:33:35 ET]
Table 'Arneb' 6-max Seat #1 is the button
Seat 1: Jagf0010 (€2.96 in chips)
Seat 2: BiggieShoot (€4.07 in chips)
Seat 3: popipat (€2.09 in chips)
Seat 4: nellussus (€2.12 in chips)
Seat 5: Luckers712 (€6.30 in chips)
Seat 6: amotinado85 (€2.36 in chips)
BiggieShoot: posts small blind €0.01
popipat: posts big blind €0.02
*** HOLE CARDS ***
Dealt to Luckers712 [Kd 8d]
nellussus: raises €0.04 to €0.06
Luckers712: calls €0.06
amotinado85: folds
Jagf0010: folds
BiggieShoot: folds
popipat: calls €0.04
*** FLOP *** [Qs 3h 4s]
popipat: checks
nellussus: bets €0.12
Luckers712: folds
popipat: folds
Uncalled bet (€0.12) returned to nellussus
nellussus collected €0.18 from pot
nellussus: doesn't show hand
*** SUMMARY ***
Total pot €0.19 | Rake €0.01
Board [Qs 3h 4s]
Seat 1: Jagf0010 (button) folded before Flop (didn't bet)
Seat 2: BiggieShoot (small blind) folded before Flop
Seat 3: popipat (big blind) folded on the Flop
Seat 4: nellussus collected (€0.18)
Seat 5: Luckers712 folded on the Flop
Seat 6: amotinado85 folded before Flop (didn't bet)



PokerStars Zoom Hand #210173394429:  Hold'em No Limit (€0.01/€0.02) - 2020/03/15 20:34:00 CET [2020/03/15 15:34:00 ET]
Table 'Arneb' 6-max Seat #1 is the button
Seat 1: Ataskador (€2 in chips)
Seat 2: Jans2011 (€4.14 in chips)
Seat 3: pepedopacio (€2.25 in chips)
Seat 4: Luckers712 (€6.24 in chips)
Seat 5: ricmp (€3.61 in chips)
Seat 6: C.Guerreiro11 (€3.18 in chips)
Jans2011: posts small blind €0.01
pepedopacio: posts big blind €0.02
*** HOLE CARDS ***
Dealt to Luckers712 [Ks 3s]
Luckers712: folds
ricmp: raises €0.04 to €0.06
C.Guerreiro11: folds
Ataskador: folds
Jans2011: folds
pepedopacio: folds
Uncalled bet (€0.04) returned to ricmp
ricmp collected €0.05 from pot
ricmp: doesn't show hand
*** SUMMARY ***
Total pot €0.05 | Rake €0
Seat 1: Ataskador (button) folded before Flop (didn't bet)
Seat 2: Jans2011 (small blind) folded before Flop
Seat 3: pepedopacio (big blind) folded before Flop
Seat 4: Luckers712 folded before Flop (didn't bet)
Seat 5: ricmp collected (€0.05)
Seat 6: C.Guerreiro11 folded before Flop (didn't bet)



PokerStars Zoom Hand #210173398330:  Hold'em No Limit (€0.01/€0.02) - 2020/03/15 20:34:04 CET [2020/03/15 15:34:04 ET]
Table 'Arneb' 6-max Seat #1 is the button
Seat 1: Luckers712 (€6.24 in chips)
Seat 2: pabmesa (€1.93 in chips)
Seat 3: rangerxx11 (€2.80 in chips)
Seat 4: usskul_44 (€0.84 in chips)
Seat 5: neolha (€2.68 in chips)
Seat 6: maritz12 (€2.68 in chips)
pabmesa: posts small blind €0.01
rangerxx11: posts big blind €0.02
*** HOLE CARDS ***
Dealt to Luckers712 [7d Ah]
usskul_44: folds
neolha: folds
maritz12: raises €0.04 to €0.06
Luckers712: calls €0.06
pabmesa: folds
rangerxx11: folds
*** FLOP *** [7c Jh Ts]
maritz12: bets €0.10
Luckers712: calls €0.10
*** TURN *** [7c Jh Ts] [Ad]
maritz12: checks
Luckers712: bets €0.17
maritz12: folds
Uncalled bet (€0.17) returned to Luckers712
Luckers712 collected €0.33 from pot
Luckers712: doesn't show hand
*** SUMMARY ***
Total pot €0.35 | Rake €0.02
Board [7c Jh Ts Ad]
Seat 1: Luckers712 (button) collected (€0.33)
Seat 2: pabmesa (small blind) folded before Flop
Seat 3: rangerxx11 (big blind) folded before Flop
Seat 4: usskul_44 folded before Flop (didn't bet)
Seat 5: neolha folded before Flop (didn't bet)
Seat 6: maritz12 folded on the Turn



PokerStars Zoom Hand #210173435921:  Hold'em No Limit (€0.01/€0.02) - 2020/03/15 20:34:43 CET [2020/03/15 15:34:43 ET]
Table 'Arneb' 6-max Seat #1 is the button
Seat 1: jacksparr485 (€2.07 in chips)
Seat 2: Séneca Magic (€11.21 in chips)
Seat 3: Luckers712 (€6.41 in chips)
Seat 4: rom1derouen (€3.56 in chips)
Seat 5: Ataskador (€2.29 in chips)
Seat 6: Richitopas (€2.13 in chips)
Séneca Magic: posts small blind €0.01
Luckers712: posts big blind €0.02
*** HOLE CARDS ***
Dealt to Luckers712 [Js Jc]
rom1derouen: folds
Ataskador: folds
Richitopas: calls €0.02
jacksparr485: folds
Séneca Magic: raises €0.08 to €0.10
Luckers712: calls €0.08
Richitopas: calls €0.08
*** FLOP *** [9h 8s 6h]
Séneca Magic: bets €0.28
Luckers712: calls €0.28
Richitopas: folds
*** TURN *** [9h 8s 6h] [5s]
Séneca Magic: checks
Luckers712: bets €0.30
Séneca Magic: calls €0.30
*** RIVER *** [9h 8s 6h 5s] [Th]
Séneca Magic: checks
Luckers712: checks
*** SHOW DOWN ***
Séneca Magic: shows [8h 8d] (three of a kind, Eights)
Luckers712: mucks hand
Séneca Magic collected €1.39 from pot
*** SUMMARY ***
Total pot €1.46 | Rake €0.07
Board [9h 8s 6h 5s Th]
Seat 1: jacksparr485 (button) folded before Flop (didn't bet)
Seat 2: Séneca Magic (small blind) showed [8h 8d] and won (€1.39) with three of a kind, Eights
Seat 3: Luckers712 (big blind) mucked [Js Jc]
Seat 4: rom1derouen folded before Flop (didn't bet)
Seat 5: Ataskador folded before Flop (didn't bet)
Seat 6: Richitopas folded on the Flop



PokerStars Zoom Hand #210173522991:  Hold'em No Limit (€0.01/€0.02) - 2020/03/15 20:36:04 CET [2020/03/15 15:36:04 ET]
Table 'Arneb' 6-max Seat #1 is the button
Seat 1: ojukwuxs (€4.34 in chips)
Seat 2: Luckers712 (€5.73 in chips)
Seat 3: ElvasSniper (€3.24 in chips)
Seat 4: Ataskador (€2 in chips)
Seat 5: trilita1952 (€0.97 in chips)
Seat 6: Jagf0010 (€2.19 in chips)
Luckers712: posts small blind €0.01
ElvasSniper: posts big blind €0.02
*** HOLE CARDS ***
Dealt to Luckers712 [9h Ad]
Ataskador: folds
trilita1952: calls €0.02
Jagf0010: raises €0.08 to €0.10
ojukwuxs: folds
Luckers712: folds
ElvasSniper: folds
trilita1952: calls €0.08
*** FLOP *** [7d 7c 9s]
trilita1952: checks
Jagf0010: bets €0.12
trilita1952: folds
Uncalled bet (€0.12) returned to Jagf0010
Jagf0010 collected €0.22 from pot
Jagf0010: doesn't show hand
*** SUMMARY ***
Total pot €0.23 | Rake €0.01
Board [7d 7c 9s]
Seat 1: ojukwuxs (button) folded before Flop (didn't bet)
Seat 2: Luckers712 (small blind) folded before Flop
Seat 3: ElvasSniper (big blind) folded before Flop
Seat 4: Ataskador folded before Flop (didn't bet)
Seat 5: trilita1952 folded on the Flop
Seat 6: Jagf0010 collected (€0.22)



PokerStars Zoom Hand #210173541203:  Hold'em No Limit (€0.01/€0.02) - 2020/03/15 20:36:23 CET [2020/03/15 15:36:23 ET]
Table 'Arneb' 6-max Seat #1 is the button
Seat 1: ricmp (€4.99 in chips)
Seat 2: eurofifghter (€2.84 in chips)
Seat 3: P@JÜ.- (€0.64 in chips)
Seat 4: Luckers712 (€5.72 in chips)
Seat 5: unounoporfavor (€10.51 in chips)
Seat 6: Pancorb (€2.28 in chips)
eurofifghter: posts small blind €0.01
P@JÜ.-: posts big blind €0.02
*** HOLE CARDS ***
Dealt to Luckers712 [Jc Kd]
Luckers712: raises €0.03 to €0.05
unounoporfavor: folds
Pancorb: folds
ricmp: folds
eurofifghter: folds
P@JÜ.-: folds
Uncalled bet (€0.03) returned to Luckers712
Luckers712 collected €0.05 from pot
Luckers712: doesn't show hand
*** SUMMARY ***
Total pot €0.05 | Rake €0
Seat 1: ricmp (button) folded before Flop (didn't bet)
Seat 2: eurofifghter (small blind) folded before Flop
Seat 3: P@JÜ.- (big blind) folded before Flop
Seat 4: Luckers712 collected (€0.05)
Seat 5: unounoporfavor folded before Flop (didn't bet)
Seat 6: Pancorb folded before Flop (didn't bet)



PokerStars Zoom Hand #210173565468:  Hold'em No Limit (€0.01/€0.02) - 2020/03/15 20:36:48 CET [2020/03/15 15:36:48 ET]
Table 'Arneb' 6-max Seat #1 is the button
Seat 1: Richitopas (€1.93 in chips)
Seat 2: MaldiniCapitano (€2.31 in chips)
Seat 3: Luckers712 (€5.75 in chips)
Seat 4: aspirato (€1.98 in chips)
Seat 5: BiggieShoot (€6.73 in chips)
Seat 6: Chunclis (€0.84 in chips)
MaldiniCapitano: posts small blind €0.01
Luckers712: posts big blind €0.02
*** HOLE CARDS ***
Dealt to Luckers712 [Ac 3c]
aspirato: folds
BiggieShoot: folds
Chunclis: folds
Richitopas: folds
MaldiniCapitano: folds
Uncalled bet (€0.01) returned to Luckers712
Luckers712 collected €0.02 from pot
Luckers712: doesn't show hand
*** SUMMARY ***
Total pot €0.02 | Rake €0
Seat 1: Richitopas (button) folded before Flop (didn't bet)
Seat 2: MaldiniCapitano (small blind) folded before Flop
Seat 3: Luckers712 (big blind) collected (€0.02)
Seat 4: aspirato folded before Flop (didn't bet)
Seat 5: BiggieShoot folded before Flop (didn't bet)
Seat 6: Chunclis folded before Flop (didn't bet)



PokerStars Zoom Hand #210173536466:  Hold'em No Limit (€0.01/€0.02) - 2020/03/15 20:36:18 CET [2020/03/15 15:36:18 ET]
Table 'Arneb' 6-max Seat #1 is the button
Seat 1: Seron1023 (€2 in chips)
Seat 2: boro928 (€1.30 in chips)
Seat 3: GÜILLIUS (€1.92 in chips)
Seat 4: neolha (€2.91 in chips)
Seat 5: golfodeases (€2.21 in chips)
Seat 6: Luckers712 (€5.72 in chips)
boro928: posts small blind €0.01
GÜILLIUS: posts big blind €0.02
*** HOLE CARDS ***
Dealt to Luckers712 [Jh 9c]
neolha: raises €0.04 to €0.06
golfodeases: calls €0.06
Luckers712: folds
Seron1023: folds
boro928: folds
GÜILLIUS: calls €0.04
*** FLOP *** [7c Kd 4c]
GÜILLIUS: bets €0.04
neolha: calls €0.04
golfodeases: calls €0.04
*** TURN *** [7c Kd 4c] [4d]
GÜILLIUS: checks
neolha: bets €0.20
golfodeases: folds
GÜILLIUS: folds
Uncalled bet (€0.20) returned to neolha
neolha collected €0.29 from pot
neolha: doesn't show hand
*** SUMMARY ***
Total pot €0.31 | Rake €0.02
Board [7c Kd 4c 4d]
Seat 1: Seron1023 (button) folded before Flop (didn't bet)
Seat 2: boro928 (small blind) folded before Flop
Seat 3: GÜILLIUS (big blind) folded on the Turn
Seat 4: neolha collected (€0.29)
Seat 5: golfodeases folded on the Turn
Seat 6: Luckers712 folded before Flop (didn't bet)



PokerStars Zoom Hand #210173556674:  Hold'em No Limit (€0.01/€0.02) - 2020/03/15 20:36:39 CET [2020/03/15 15:36:39 ET]
Table 'Arneb' 6-max Seat #1 is the button
Seat 1: Frisar (€0.97 in chips)
Seat 2: amotinado85 (€2 in chips)
Seat 3: ERIZOCACHO (€1.81 in chips)
Seat 4: MDKristian (€1.28 in chips)
Seat 5: Luckers712 (€5.75 in chips)
Seat 6: marbad19 (€4.03 in chips)
amotinado85: posts small blind €0.01
ERIZOCACHO: posts big blind €0.02
*** HOLE CARDS ***
Dealt to Luckers712 [4d 2s]
MDKristian: folds
Luckers712: folds
marbad19: raises €0.04 to €0.06
Frisar: folds
amotinado85: folds
ERIZOCACHO: raises €0.17 to €0.23
marbad19: folds
Uncalled bet (€0.17) returned to ERIZOCACHO
ERIZOCACHO collected €0.13 from pot
ERIZOCACHO: doesn't show hand
*** SUMMARY ***
Total pot €0.13 | Rake €0
Seat 1: Frisar (button) folded before Flop (didn't bet)
Seat 2: amotinado85 (small blind) folded before Flop
Seat 3: ERIZOCACHO (big blind) collected (€0.13)
Seat 4: MDKristian folded before Flop (didn't bet)
Seat 5: Luckers712 folded before Flop (didn't bet)
Seat 6: marbad19 folded before Flop



PokerStars Zoom Hand #210173561522:  Hold'em No Limit (€0.01/€0.02) - 2020/03/15 20:36:44 CET [2020/03/15 15:36:44 ET]
Table 'Arneb' 6-max Seat #1 is the button
Seat 1: Jagf0010 (€7.96 in chips)
Seat 2: serbot131 (€3.01 in chips)
Seat 3: caran solo (€1.25 in chips)
Seat 4: Luckers712 (€5.75 in chips)
Seat 5: Munrra10 (€2.13 in chips)
Seat 6: 1995almeida71 (€1.14 in chips)
serbot131: posts small blind €0.01
caran solo: posts big blind €0.02
*** HOLE CARDS ***
Dealt to Luckers712 [5h 4s]
Luckers712: folds
Munrra10: raises €0.04 to €0.06
1995almeida71: folds
Jagf0010: folds
serbot131: folds
caran solo: calls €0.04
*** FLOP *** [7c 2c Th]
caran solo: bets €0.02
Munrra10: raises €0.05 to €0.07
caran solo: calls €0.05
*** TURN *** [7c 2c Th] [Jc]
caran solo: checks
Munrra10: bets €0.08
caran solo: calls €0.08
*** RIVER *** [7c 2c Th Jc] [Kc]
caran solo: checks
Munrra10: checks
*** SHOW DOWN ***
caran solo: shows [2h 2s] (three of a kind, Deuces)
Munrra10: shows [8c Tc] (a flush, King high)
Munrra10 collected €0.41 from pot
*** SUMMARY ***
Total pot €0.43 | Rake €0.02
Board [7c 2c Th Jc Kc]
Seat 1: Jagf0010 (button) folded before Flop (didn't bet)
Seat 2: serbot131 (small blind) folded before Flop
Seat 3: caran solo (big blind) showed [2h 2s] and lost with three of a kind, Deuces
Seat 4: Luckers712 folded before Flop (didn't bet)
Seat 5: Munrra10 showed [8c Tc] and won (€0.41) with a flush, King high
Seat 6: 1995almeida71 folded before Flop (didn't bet)



PokerStars Zoom Hand #210173573047:  Hold'em No Limit (€0.01/€0.02) - 2020/03/15 20:36:56 CET [2020/03/15 15:36:56 ET]
Table 'Arneb' 6-max Seat #1 is the button
Seat 1: Luckers712 (€5.76 in chips)
Seat 2: zlatanwise (€2.13 in chips)
Seat 3: kremmel91 (€2.62 in chips)
Seat 4: Robersaz (€6.39 in chips)
Seat 5: GLICHGAM1NG (€2.39 in chips)
Seat 6: Villano236 (€2 in chips)
zlatanwise: posts small blind €0.01
kremmel91: posts big blind €0.02
*** HOLE CARDS ***
Dealt to Luckers712 [Kd Ac]
Robersaz: raises €0.05 to €0.07
GLICHGAM1NG: folds
Villano236: folds
Luckers712: calls €0.07
zlatanwise: folds
kremmel91: folds
*** FLOP *** [9h Tc As]
Robersaz: bets €0.16
Luckers712: raises €0.25 to €0.41
Robersaz: folds
Uncalled bet (€0.25) returned to Luckers712
Luckers712 collected €0.47 from pot
Luckers712: doesn't show hand
*** SUMMARY ***
Total pot €0.49 | Rake €0.02
Board [9h Tc As]
Seat 1: Luckers712 (button) collected (€0.47)
Seat 2: zlatanwise (small blind) folded before Flop
Seat 3: kremmel91 (big blind) folded before Flop
Seat 4: Robersaz folded on the Flop
Seat 5: GLICHGAM1NG folded before Flop (didn't bet)
Seat 6: Villano236 folded before Flop (didn't bet)



PokerStars Zoom Hand #210173621786:  Hold'em No Limit (€0.01/€0.02) - 2020/03/15 20:37:47 CET [2020/03/15 15:37:47 ET]
Table 'Arneb' 6-max Seat #1 is the button
Seat 1: MaurusT (€1.66 in chips)
Seat 2: triatlon23 (€2.03 in chips)
Seat 3: pepedopacio (€2.02 in chips)
Seat 4: PrOdI11 (€7.04 in chips)
Seat 5: Munrra10 (€3.04 in chips)
Seat 6: Luckers712 (€5.99 in chips)
triatlon23: posts small blind €0.01
pepedopacio: posts big blind €0.02
*** HOLE CARDS ***
Dealt to Luckers712 [5d 8c]
PrOdI11: raises €0.02 to €0.04
Munrra10: folds
Luckers712: folds
MaurusT: folds
triatlon23: folds
pepedopacio: folds
Uncalled bet (€0.02) returned to PrOdI11
PrOdI11 collected €0.05 from pot
PrOdI11: doesn't show hand
*** SUMMARY ***
Total pot €0.05 | Rake €0
Seat 1: MaurusT (button) folded before Flop (didn't bet)
Seat 2: triatlon23 (small blind) folded before Flop
Seat 3: pepedopacio (big blind) folded before Flop
Seat 4: PrOdI11 collected (€0.05)
Seat 5: Munrra10 folded before Flop (didn't bet)
Seat 6: Luckers712 folded before Flop (didn't bet)



PokerStars Zoom Hand #210173631548:  Hold'em No Limit (€0.01/€0.02) - 2020/03/15 20:37:55 CET [2020/03/15 15:37:55 ET]
Table 'Arneb' 6-max Seat #1 is the button
Seat 1: crrio (€0.40 in chips)
Seat 2: pepedopacio (€2 in chips)
Seat 3: MaurusT (€1.43 in chips)
Seat 4: bingueiro69 (€2.07 in chips)
Seat 5: Luckers712 (€5.99 in chips)
Seat 6: TheShrimp8 (€2.51 in chips)
pepedopacio: posts small blind €0.01
MaurusT: posts big blind €0.02
*** HOLE CARDS ***
Dealt to Luckers712 [Qd 2s]
bingueiro69: folds
Luckers712: folds
TheShrimp8: folds
crrio: raises €0.02 to €0.04
pepedopacio: folds
MaurusT: folds
Uncalled bet (€0.02) returned to crrio
crrio collected €0.05 from pot
crrio: doesn't show hand
*** SUMMARY ***
Total pot €0.05 | Rake €0
Seat 1: crrio (button) collected (€0.05)
Seat 2: pepedopacio (small blind) folded before Flop
Seat 3: MaurusT (big blind) folded before Flop
Seat 4: bingueiro69 folded before Flop (didn't bet)
Seat 5: Luckers712 folded before Flop (didn't bet)
Seat 6: TheShrimp8 folded before Flop (didn't bet)



PokerStars Zoom Hand #210173617111:  Hold'em No Limit (€0.01/€0.02) - 2020/03/15 20:37:42 CET [2020/03/15 15:37:42 ET]
Table 'Arneb' 6-max Seat #1 is the button
Seat 1: tetar1000d (€2 in chips)
Seat 2: Luckers712 (€6 in chips)
Seat 3: Vitorhcsousa (€3.46 in chips)
Seat 4: javigarrido8 (€2.19 in chips)
Seat 5: serbot131 (€0.46 in chips)
Seat 6: Ataskador (€2 in chips)
Luckers712: posts small blind €0.01
Vitorhcsousa: posts big blind €0.02
*** HOLE CARDS ***
Dealt to Luckers712 [Kh 7s]
javigarrido8: folds
serbot131: folds
Ataskador has timed out
Ataskador: folds
tetar1000d: raises €0.02 to €0.04
Luckers712: folds
Vitorhcsousa: calls €0.02
*** FLOP *** [6h 5h Qd]
Vitorhcsousa: checks
tetar1000d: bets €0.03
Vitorhcsousa: folds
Uncalled bet (€0.03) returned to tetar1000d
tetar1000d collected €0.09 from pot
tetar1000d: doesn't show hand
*** SUMMARY ***
Total pot €0.09 | Rake €0
Board [6h 5h Qd]
Seat 1: tetar1000d (button) collected (€0.09)
Seat 2: Luckers712 (small blind) folded before Flop
Seat 3: Vitorhcsousa (big blind) folded on the Flop
Seat 4: javigarrido8 folded before Flop (didn't bet)
Seat 5: serbot131 folded before Flop (didn't bet)
Seat 6: Ataskador folded before Flop (didn't bet)



PokerStars Zoom Hand #210173645870:  Hold'em No Limit (€0.01/€0.02) - 2020/03/15 20:38:10 CET [2020/03/15 15:38:10 ET]
Table 'Arneb' 6-max Seat #1 is the button
Seat 1: Luckers712 (€5.97 in chips)
Seat 2: unounoporfavor (€2 in chips)
Seat 3: Frisar (€1 in chips)
Seat 4: trilita1952 (€0.96 in chips)
Seat 5: V_Morghuliss (€2.90 in chips)
Seat 6: WaNtEd_o0 (€1.88 in chips)
unounoporfavor: posts small blind €0.01
Frisar: posts big blind €0.02
*** HOLE CARDS ***
Dealt to Luckers712 [2d Ts]
trilita1952: folds
V_Morghuliss: folds
WaNtEd_o0: folds
Luckers712: folds
unounoporfavor: raises €0.02 to €0.04
Frisar: folds
Uncalled bet (€0.02) returned to unounoporfavor
unounoporfavor collected €0.04 from pot
unounoporfavor: doesn't show hand
*** SUMMARY ***
Total pot €0.04 | Rake €0
Seat 1: Luckers712 (button) folded before Flop (didn't bet)
Seat 2: unounoporfavor (small blind) collected (€0.04)
Seat 3: Frisar (big blind) folded before Flop
Seat 4: trilita1952 folded before Flop (didn't bet)
Seat 5: V_Morghuliss folded before Flop (didn't bet)
Seat 6: WaNtEd_o0 folded before Flop (didn't bet)



PokerStars Zoom Hand #210173659347:  Hold'em No Limit (€0.01/€0.02) - 2020/03/15 20:38:24 CET [2020/03/15 15:38:24 ET]
Table 'Arneb' 6-max Seat #1 is the button
Seat 1: Luckers712 (€5.96 in chips)
Seat 2: silvago1 (€1.87 in chips)
Seat 3: Jans2011 (€4.14 in chips)
Seat 4: Agnester14 (€1.32 in chips)
Seat 5: Jagf0010 (€2.68 in chips)
Seat 6: andresrodr8 (€2 in chips)
silvago1: posts small blind €0.01
Jans2011: posts big blind €0.02
*** HOLE CARDS ***
Dealt to Luckers712 [8h Qh]
Agnester14: folds
Jagf0010: folds
andresrodr8: folds
Luckers712: raises €0.03 to €0.05
silvago1: folds
Jans2011: folds
Uncalled bet (€0.03) returned to Luckers712
Luckers712 collected €0.05 from pot
Luckers712: doesn't show hand
*** SUMMARY ***
Total pot €0.05 | Rake €0
Seat 1: Luckers712 (button) collected (€0.05)
Seat 2: silvago1 (small blind) folded before Flop
Seat 3: Jans2011 (big blind) folded before Flop
Seat 4: Agnester14 folded before Flop (didn't bet)
Seat 5: Jagf0010 folded before Flop (didn't bet)
Seat 6: andresrodr8 folded before Flop (didn't bet)



PokerStars Zoom Hand #210173655407:  Hold'em No Limit (€0.01/€0.02) - 2020/03/15 20:38:20 CET [2020/03/15 15:38:20 ET]
Table 'Arneb' 6-max Seat #1 is the button
Seat 1: maritz12 (€3.70 in chips)
Seat 2: Luckers712 (€5.97 in chips)
Seat 3: talhovsky28 (€2 in chips)
Seat 4: jacksparr485 (€2.02 in chips)
Seat 5: santosmc88 (€0.94 in chips)
Seat 6: BiggieShoot (€5.86 in chips)
Luckers712: posts small blind €0.01
talhovsky28: posts big blind €0.02
*** HOLE CARDS ***
Dealt to Luckers712 [Js 2s]
jacksparr485 has timed out
jacksparr485: folds
santosmc88: folds
BiggieShoot: folds
maritz12: folds
Luckers712: folds
Uncalled bet (€0.01) returned to talhovsky28
talhovsky28 collected €0.02 from pot
talhovsky28: doesn't show hand
*** SUMMARY ***
Total pot €0.02 | Rake €0
Seat 1: maritz12 (button) folded before Flop (didn't bet)
Seat 2: Luckers712 (small blind) folded before Flop
Seat 3: talhovsky28 (big blind) collected (€0.02)
Seat 4: jacksparr485 folded before Flop (didn't bet)
Seat 5: santosmc88 folded before Flop (didn't bet)
Seat 6: BiggieShoot folded before Flop (didn't bet)



PokerStars Zoom Hand #210173625515:  Hold'em No Limit (€0.01/€0.02) - 2020/03/15 20:37:51 CET [2020/03/15 15:37:51 ET]
Table 'Arneb' 6-max Seat #1 is the button
Seat 1: A8kill (€3.46 in chips)
Seat 2: eurofifghter (€1.01 in chips)
Seat 3: so0tas (€2.07 in chips)
Seat 4: ERIZOCACHO (€1.87 in chips)
Seat 5: Luckers712 (€5.99 in chips)
Seat 6: romex0 (€2.85 in chips)
eurofifghter: posts small blind €0.01
so0tas: posts big blind €0.02
*** HOLE CARDS ***
Dealt to Luckers712 [4d Jd]
ERIZOCACHO: folds
Luckers712: folds
romex0: folds
A8kill: raises €0.04 to €0.06
eurofifghter: calls €0.05
so0tas: calls €0.04
*** FLOP *** [4c 8d 2s]
eurofifghter: bets €0.12
so0tas: folds
A8kill: calls €0.12
*** TURN *** [4c 8d 2s] [8s]
eurofifghter: bets €0.32
A8kill: folds
Uncalled bet (€0.32) returned to eurofifghter
eurofifghter collected €0.40 from pot
eurofifghter: doesn't show hand
*** SUMMARY ***
Total pot €0.42 | Rake €0.02
Board [4c 8d 2s 8s]
Seat 1: A8kill (button) folded on the Turn
Seat 2: eurofifghter (small blind) collected (€0.40)
Seat 3: so0tas (big blind) folded on the Flop
Seat 4: ERIZOCACHO folded before Flop (didn't bet)
Seat 5: Luckers712 folded before Flop (didn't bet)
Seat 6: romex0 folded before Flop (didn't bet)



PokerStars Zoom Hand #210173651604:  Hold'em No Limit (€0.01/€0.02) - 2020/03/15 20:38:16 CET [2020/03/15 15:38:16 ET]
Table 'Arneb' 6-max Seat #1 is the button
Seat 1: PrOdI11 (€2.23 in chips)
Seat 2: jacksparr485 (€2.03 in chips)
Seat 3: lusto09 (€8.93 in chips)
Seat 4: Chunclis (€3.21 in chips)
Seat 5: MaldiniCapitano (€2.54 in chips)
Seat 6: Luckers712 (€5.97 in chips)
jacksparr485: posts small blind €0.01
lusto09: posts big blind €0.02
*** HOLE CARDS ***
Dealt to Luckers712 [8s 3h]
Chunclis: folds
MaldiniCapitano: raises €0.05 to €0.07
Luckers712: folds
PrOdI11: calls €0.07
jacksparr485: folds
lusto09: folds
*** FLOP *** [8c 5h 3c]
MaldiniCapitano: checks
PrOdI11: bets €0.08
MaldiniCapitano: calls €0.08
*** TURN *** [8c 5h 3c] [Kd]
MaldiniCapitano: checks
PrOdI11: checks
*** RIVER *** [8c 5h 3c Kd] [Qd]
MaldiniCapitano: checks
PrOdI11: checks
*** SHOW DOWN ***
MaldiniCapitano: shows [7d 7c] (a pair of Sevens)
PrOdI11: shows [Th 8h] (a pair of Eights)
PrOdI11 collected €0.31 from pot
*** SUMMARY ***
Total pot €0.33 | Rake €0.02
Board [8c 5h 3c Kd Qd]
Seat 1: PrOdI11 (button) showed [Th 8h] and won (€0.31) with a pair of Eights
Seat 2: jacksparr485 (small blind) folded before Flop
Seat 3: lusto09 (big blind) folded before Flop
Seat 4: Chunclis folded before Flop (didn't bet)
Seat 5: MaldiniCapitano showed [7d 7c] and lost with a pair of Sevens
Seat 6: Luckers712 folded before Flop (didn't bet)



PokerStars Zoom Hand #210173635357:  Hold'em No Limit (€0.01/€0.02) - 2020/03/15 20:37:59 CET [2020/03/15 15:37:59 ET]
Table 'Arneb' 6-max Seat #1 is the button
Seat 1: loudydrix (€2.50 in chips)
Seat 2: neolha (€3.55 in chips)
Seat 3: Luckers712 (€5.99 in chips)
Seat 4: bandittours (€5.96 in chips)
Seat 5: rom1derouen (€3.85 in chips)
Seat 6: Gllaedr (€4.74 in chips)
neolha: posts small blind €0.01
Luckers712: posts big blind €0.02
*** HOLE CARDS ***
Dealt to Luckers712 [5s 3h]
bandittours: folds
rom1derouen: raises €0.04 to €0.06
Gllaedr: calls €0.06
loudydrix: calls €0.06
neolha: folds
Luckers712: folds
*** FLOP *** [9d 2c Ks]
rom1derouen: checks
Gllaedr: checks
loudydrix: checks
*** TURN *** [9d 2c Ks] [Ac]
rom1derouen: bets €0.13
Gllaedr: calls €0.13
loudydrix: folds
*** RIVER *** [9d 2c Ks Ac] [Tc]
rom1derouen: bets €0.30
Gllaedr: calls €0.30
*** SHOW DOWN ***
rom1derouen: shows [Ad 2d] (two pair, Aces and Deuces)
Gllaedr: shows [Ah 9h] (two pair, Aces and Nines)
Gllaedr collected €1.02 from pot
*** SUMMARY ***
Total pot €1.07 | Rake €0.05
Board [9d 2c Ks Ac Tc]
Seat 1: loudydrix (button) folded on the Turn
Seat 2: neolha (small blind) folded before Flop
Seat 3: Luckers712 (big blind) folded before Flop
Seat 4: bandittours folded before Flop (didn't bet)
Seat 5: rom1derouen showed [Ad 2d] and lost with two pair, Aces and Deuces
Seat 6: Gllaedr showed [Ah 9h] and won (€1.02) with two pair, Aces and Nines



PokerStars Zoom Hand #210173670875:  Hold'em No Limit (€0.01/€0.02) - 2020/03/15 20:38:36 CET [2020/03/15 15:38:36 ET]
Table 'Arneb' 6-max Seat #1 is the button
Seat 1: Helder08 (€2.81 in chips)
Seat 2: Veesile (€2.11 in chips)
Seat 3: Luckers712 (€5.99 in chips)
Seat 4: lusto09 (€8.91 in chips)
Seat 5: lunasa (€2.88 in chips)
Seat 6: roms421984 (€0.09 in chips)
Veesile: posts small blind €0.01
Luckers712: posts big blind €0.02
*** HOLE CARDS ***
Dealt to Luckers712 [6c Ks]
lusto09: folds
lunasa: folds
roms421984: folds
Helder08: folds
Veesile: raises €0.04 to €0.06
Luckers712: calls €0.04
*** FLOP *** [5s Ac 6s]
Veesile: checks
Luckers712: bets €0.06
Veesile: calls €0.06
*** TURN *** [5s Ac 6s] [Kd]
Veesile: checks
Luckers712: bets €0.14
Veesile: raises €0.24 to €0.38
Luckers712: raises €0.24 to €0.62
Veesile: raises €0.32 to €0.94
Luckers712: raises €4.93 to €5.87 and is all-in
Veesile: folds
Uncalled bet (€4.93) returned to Luckers712
Luckers712 collected €2.01 from pot
Luckers712: doesn't show hand
*** SUMMARY ***
Total pot €2.12 | Rake €0.11
Board [5s Ac 6s Kd]
Seat 1: Helder08 (button) folded before Flop (didn't bet)
Seat 2: Veesile (small blind) folded on the Turn
Seat 3: Luckers712 (big blind) collected (€2.01)
Seat 4: lusto09 folded before Flop (didn't bet)
Seat 5: lunasa folded before Flop (didn't bet)
Seat 6: roms421984 folded before Flop (didn't bet)



PokerStars Zoom Hand #210173735966:  Hold'em No Limit (€0.01/€0.02) - 2020/03/15 20:39:44 CET [2020/03/15 15:39:44 ET]
Table 'Arneb' 6-max Seat #1 is the button
Seat 1: Veesile (€2 in chips)
Seat 2: Luckers712 (€6.94 in chips)
Seat 3: romex0 (€2.79 in chips)
Seat 4: lusto09 (€3.35 in chips)
Seat 5: Villano236 (€2.09 in chips)
Seat 6: MaldiniCapitano (€3.44 in chips)
Luckers712: posts small blind €0.01
romex0: posts big blind €0.02
*** HOLE CARDS ***
Dealt to Luckers712 [2d 9c]
lusto09: folds
Villano236: folds
MaldiniCapitano: folds
Veesile: raises €0.04 to €0.06
Luckers712: folds
romex0: folds
Uncalled bet (€0.04) returned to Veesile
Veesile collected €0.05 from pot
Veesile: doesn't show hand
*** SUMMARY ***
Total pot €0.05 | Rake €0
Seat 1: Veesile (button) collected (€0.05)
Seat 2: Luckers712 (small blind) folded before Flop
Seat 3: romex0 (big blind) folded before Flop
Seat 4: lusto09 folded before Flop (didn't bet)
Seat 5: Villano236 folded before Flop (didn't bet)
Seat 6: MaldiniCapitano folded before Flop (didn't bet)



PokerStars Zoom Hand #210173739753:  Hold'em No Limit (€0.01/€0.02) - 2020/03/15 20:39:48 CET [2020/03/15 15:39:48 ET]
Table 'Arneb' 6-max Seat #1 is the button
Seat 1: alvaroa1888 (€2 in chips)
Seat 2: MaurusT (€1.96 in chips)
Seat 3: maritz12 (€2 in chips)
Seat 4: Luckers712 (€6.93 in chips)
Seat 5: SaiyanSergio (€2.73 in chips)
Seat 6: Pancorb (€2.21 in chips)
MaurusT: posts small blind €0.01
maritz12: posts big blind €0.02
*** HOLE CARDS ***
Dealt to Luckers712 [4s 9c]
Luckers712: folds
SaiyanSergio: raises €0.04 to €0.06
Pancorb: folds
alvaroa1888: folds
MaurusT: folds
maritz12: folds
Uncalled bet (€0.04) returned to SaiyanSergio
SaiyanSergio collected €0.05 from pot
SaiyanSergio: doesn't show hand
*** SUMMARY ***
Total pot €0.05 | Rake €0
Seat 1: alvaroa1888 (button) folded before Flop (didn't bet)
Seat 2: MaurusT (small blind) folded before Flop
Seat 3: maritz12 (big blind) folded before Flop
Seat 4: Luckers712 folded before Flop (didn't bet)
Seat 5: SaiyanSergio collected (€0.05)
Seat 6: Pancorb folded before Flop (didn't bet)



PokerStars Zoom Hand #210173749328:  Hold'em No Limit (€0.01/€0.02) - 2020/03/15 20:39:58 CET [2020/03/15 15:39:58 ET]
Table 'Arneb' 6-max Seat #1 is the button
Seat 1: alvaroa1888 (€2 in chips)
Seat 2: ricmp (€5.01 in chips)
Seat 3: A8kill (€3.77 in chips)
Seat 4: MaldiniCapitano (€2.01 in chips)
Seat 5: Luckers712 (€6.93 in chips)
Seat 6: Gllaedr (€2.37 in chips)
ricmp: posts small blind €0.01
A8kill: posts big blind €0.02
*** HOLE CARDS ***
Dealt to Luckers712 [Qh 8d]
MaldiniCapitano: folds
Luckers712: folds
Gllaedr: folds
alvaroa1888: folds
ricmp: folds
Uncalled bet (€0.01) returned to A8kill
A8kill collected €0.02 from pot
A8kill: doesn't show hand
*** SUMMARY ***
Total pot €0.02 | Rake €0
Seat 1: alvaroa1888 (button) folded before Flop (didn't bet)
Seat 2: ricmp (small blind) folded before Flop
Seat 3: A8kill (big blind) collected (€0.02)
Seat 4: MaldiniCapitano folded before Flop (didn't bet)
Seat 5: Luckers712 folded before Flop (didn't bet)
Seat 6: Gllaedr folded before Flop (didn't bet)



PokerStars Zoom Hand #210173745531:  Hold'em No Limit (€0.01/€0.02) - 2020/03/15 20:39:54 CET [2020/03/15 15:39:54 ET]
Table 'Arneb' 6-max Seat #1 is the button
Seat 1: Shikamaru003 (€2 in chips)
Seat 2: TheShrimp8 (€2.44 in chips)
Seat 3: pepedopacio (€2.20 in chips)
Seat 4: manusport (€2.57 in chips)
Seat 5: santaremana (€1.95 in chips)
Seat 6: Luckers712 (€6.93 in chips)
TheShrimp8: posts small blind €0.01
pepedopacio: posts big blind €0.02
*** HOLE CARDS ***
Dealt to Luckers712 [Jc 3c]
manusport: folds
santaremana: calls €0.02
Luckers712: folds
Shikamaru003: folds
TheShrimp8: folds
pepedopacio: raises €0.14 to €0.16
santaremana: folds
Uncalled bet (€0.14) returned to pepedopacio
pepedopacio collected €0.05 from pot
pepedopacio: doesn't show hand
*** SUMMARY ***
Total pot €0.05 | Rake €0
Seat 1: Shikamaru003 (button) folded before Flop (didn't bet)
Seat 2: TheShrimp8 (small blind) folded before Flop
Seat 3: pepedopacio (big blind) collected (€0.05)
Seat 4: manusport folded before Flop (didn't bet)
Seat 5: santaremana folded before Flop
Seat 6: Luckers712 folded before Flop (didn't bet)



PokerStars Zoom Hand #210173758864:  Hold'em No Limit (€0.01/€0.02) - 2020/03/15 20:40:08 CET [2020/03/15 15:40:08 ET]
Table 'Arneb' 6-max Seat #1 is the button
Seat 1: Richitopas (€1.81 in chips)
Seat 2: neolha (€2.95 in chips)
Seat 3: Anme41 (€1.96 in chips)
Seat 4: Luckers712 (€6.93 in chips)
Seat 5: Oll1Deloin (€2.51 in chips)
Seat 6: TheShrimp8 (€2.43 in chips)
neolha: posts small blind €0.01
Anme41: posts big blind €0.02
*** HOLE CARDS ***
Dealt to Luckers712 [3c 9d]
Luckers712: folds
Oll1Deloin: folds
TheShrimp8: folds
Richitopas: folds
neolha: folds
Uncalled bet (€0.01) returned to Anme41
Anme41 collected €0.02 from pot
Anme41: doesn't show hand
*** SUMMARY ***
Total pot €0.02 | Rake €0
Seat 1: Richitopas (button) folded before Flop (didn't bet)
Seat 2: neolha (small blind) folded before Flop
Seat 3: Anme41 (big blind) collected (€0.02)
Seat 4: Luckers712 folded before Flop (didn't bet)
Seat 5: Oll1Deloin folded before Flop (didn't bet)
Seat 6: TheShrimp8 folded before Flop (didn't bet)



PokerStars Zoom Hand #210173762746:  Hold'em No Limit (€0.01/€0.02) - 2020/03/15 20:40:12 CET [2020/03/15 15:40:12 ET]
Table 'Arneb' 6-max Seat #1 is the button
Seat 1: lusto09 (€3.35 in chips)
Seat 2: xegi (€1.62 in chips)
Seat 3: Luckers712 (€6.93 in chips)
Seat 4: TheShrimp8 (€2.43 in chips)
Seat 5: pichon1000 (€3.38 in chips)
Seat 6: Frisar (€1.01 in chips)
xegi: posts small blind €0.01
Luckers712: posts big blind €0.02
*** HOLE CARDS ***
Dealt to Luckers712 [5d 9h]
TheShrimp8: folds
pichon1000: folds
Frisar: raises €0.05 to €0.07
lusto09: raises €0.17 to €0.24
xegi: folds
Luckers712: folds
Frisar: folds
Uncalled bet (€0.17) returned to lusto09
lusto09 collected €0.17 from pot
lusto09: doesn't show hand
*** SUMMARY ***
Total pot €0.17 | Rake €0
Seat 1: lusto09 (button) collected (€0.17)
Seat 2: xegi (small blind) folded before Flop
Seat 3: Luckers712 (big blind) folded before Flop
Seat 4: TheShrimp8 folded before Flop (didn't bet)
Seat 5: pichon1000 folded before Flop (didn't bet)
Seat 6: Frisar folded before Flop



PokerStars Zoom Hand #210173755174:  Hold'em No Limit (€0.01/€0.02) - 2020/03/15 20:40:04 CET [2020/03/15 15:40:04 ET]
Table 'Arneb' 6-max Seat #1 is the button
Seat 1: pinneaple4 (€1.97 in chips)
Seat 2: eslavoneslavon (€2.53 in chips)
Seat 3: Veesile (€2 in chips)
Seat 4: Luckers712 (€6.93 in chips)
Seat 5: golfodeases (€3.81 in chips)
Seat 6: kisko87 (€2.11 in chips)
eslavoneslavon: posts small blind €0.01
Veesile: posts big blind €0.02
*** HOLE CARDS ***
Dealt to Luckers712 [9s 4s]
Luckers712: folds
golfodeases: calls €0.02
kisko87: folds
pinneaple4: folds
eslavoneslavon: calls €0.01
Veesile: checks
*** FLOP *** [8s 7c Qd]
eslavoneslavon: checks
Veesile: checks
golfodeases: checks
*** TURN *** [8s 7c Qd] [4d]
eslavoneslavon: bets €0.04
Veesile: folds
golfodeases: folds
Uncalled bet (€0.04) returned to eslavoneslavon
eslavoneslavon collected €0.06 from pot
eslavoneslavon: doesn't show hand
*** SUMMARY ***
Total pot €0.06 | Rake €0
Board [8s 7c Qd 4d]
Seat 1: pinneaple4 (button) folded before Flop (didn't bet)
Seat 2: eslavoneslavon (small blind) collected (€0.06)
Seat 3: Veesile (big blind) folded on the Turn
Seat 4: Luckers712 folded before Flop (didn't bet)
Seat 5: golfodeases folded on the Turn
Seat 6: kisko87 folded before Flop (didn't bet)



PokerStars Zoom Hand #210173775271:  Hold'em No Limit (€0.01/€0.02) - 2020/03/15 20:40:25 CET [2020/03/15 15:40:25 ET]
Table 'Arneb' 6-max Seat #1 is the button
Seat 1: MDKristian (€1.39 in chips)
Seat 2: Luckers712 (€6.91 in chips)
Seat 3: BiggieShoot (€3.69 in chips)
Seat 4: javigarrido8 (€2.22 in chips)
Seat 5: serbot131 (€2.55 in chips)
Seat 6: Vitorhcsousa (€3.11 in chips)
Luckers712: posts small blind €0.01
BiggieShoot: posts big blind €0.02
*** HOLE CARDS ***
Dealt to Luckers712 [8d Kc]
javigarrido8: folds
serbot131 has timed out
serbot131: folds
Vitorhcsousa: folds
MDKristian: folds
Luckers712: raises €0.04 to €0.06
BiggieShoot: calls €0.04
*** FLOP *** [8s Ks 5s]
Luckers712: checks
BiggieShoot: bets €0.03
Luckers712: raises €0.11 to €0.14
BiggieShoot: folds
Uncalled bet (€0.11) returned to Luckers712
Luckers712 collected €0.17 from pot
Luckers712: doesn't show hand
*** SUMMARY ***
Total pot €0.18 | Rake €0.01
Board [8s Ks 5s]
Seat 1: MDKristian (button) folded before Flop (didn't bet)
Seat 2: Luckers712 (small blind) collected (€0.17)
Seat 3: BiggieShoot (big blind) folded on the Flop
Seat 4: javigarrido8 folded before Flop (didn't bet)
Seat 5: serbot131 folded before Flop (didn't bet)
Seat 6: Vitorhcsousa folded before Flop (didn't bet)



PokerStars Zoom Hand #210173844292:  Hold'em No Limit (€0.01/€0.02) - 2020/03/15 20:41:37 CET [2020/03/15 15:41:37 ET]
Table 'Arneb' 6-max Seat #1 is the button
Seat 1: Robersaz (€8.04 in chips)
Seat 2: pgraca1972 (€0.82 in chips)
Seat 3: andresrodr8 (€2.03 in chips)
Seat 4: MaurusT (€2.28 in chips)
Seat 5: marbad19 (€3.85 in chips)
Seat 6: Luckers712 (€6.99 in chips)
pgraca1972: posts small blind €0.01
andresrodr8: posts big blind €0.02
*** HOLE CARDS ***
Dealt to Luckers712 [7s Tc]
MaurusT: folds
marbad19: folds
Luckers712: folds
Robersaz: folds
pgraca1972: folds
Uncalled bet (€0.01) returned to andresrodr8
andresrodr8 collected €0.02 from pot
andresrodr8: doesn't show hand
*** SUMMARY ***
Total pot €0.02 | Rake €0
Seat 1: Robersaz (button) folded before Flop (didn't bet)
Seat 2: pgraca1972 (small blind) folded before Flop
Seat 3: andresrodr8 (big blind) collected (€0.02)
Seat 4: MaurusT folded before Flop (didn't bet)
Seat 5: marbad19 folded before Flop (didn't bet)
Seat 6: Luckers712 folded before Flop (didn't bet)



PokerStars Zoom Hand #210173839352:  Hold'em No Limit (€0.01/€0.02) - 2020/03/15 20:41:32 CET [2020/03/15 15:41:32 ET]
Table 'Arneb' 6-max Seat #1 is the button
Seat 1: Luckers712 (€6.99 in chips)
Seat 2: Oll1Deloin (€2 in chips)
Seat 3: Pocas Prisas (€3.41 in chips)
Seat 4: TheShrimp8 (€2.93 in chips)
Seat 5: pgraca1972 (€0.82 in chips)
Seat 6: stylek9 (€2.19 in chips)
Oll1Deloin: posts small blind €0.01
Pocas Prisas: posts big blind €0.02
*** HOLE CARDS ***
Dealt to Luckers712 [2s 4h]
TheShrimp8: raises €0.04 to €0.06
pgraca1972: folds
stylek9: folds
Luckers712: folds
Oll1Deloin: folds
Pocas Prisas: folds
Uncalled bet (€0.04) returned to TheShrimp8
TheShrimp8 collected €0.05 from pot
TheShrimp8: doesn't show hand
*** SUMMARY ***
Total pot €0.05 | Rake €0
Seat 1: Luckers712 (button) folded before Flop (didn't bet)
Seat 2: Oll1Deloin (small blind) folded before Flop
Seat 3: Pocas Prisas (big blind) folded before Flop
Seat 4: TheShrimp8 collected (€0.05)
Seat 5: pgraca1972 folded before Flop (didn't bet)
Seat 6: stylek9 folded before Flop (didn't bet)



PokerStars Zoom Hand #210173848072:  Hold'em No Limit (€0.01/€0.02) - 2020/03/15 20:41:41 CET [2020/03/15 15:41:41 ET]
Table 'Arneb' 6-max Seat #1 is the button
Seat 1: loudydrix (€2.04 in chips)
Seat 2: C.Guerreiro11 (€3.01 in chips)
Seat 3: pepedopacio (€2 in chips)
Seat 4: Luckers712 (€6.99 in chips)
Seat 5: Robersaz (€8.04 in chips)
Seat 6: Pocas Prisas (€3.39 in chips)
C.Guerreiro11: posts small blind €0.01
pepedopacio: posts big blind €0.02
*** HOLE CARDS ***
Dealt to Luckers712 [Ah 8d]
Luckers712: folds
Robersaz: raises €0.09 to €0.11
Pocas Prisas: folds
loudydrix: calls €0.11
C.Guerreiro11: folds
pepedopacio: folds
*** FLOP *** [9s 4s 8c]
Robersaz: checks
loudydrix: checks
*** TURN *** [9s 4s 8c] [7h]
Robersaz: checks
loudydrix: checks
*** RIVER *** [9s 4s 8c 7h] [2c]
Robersaz: checks
loudydrix: checks
*** SHOW DOWN ***
Robersaz: shows [Kc 5c] (high card King)
loudydrix: shows [Js 9c] (a pair of Nines)
loudydrix collected €0.24 from pot
*** SUMMARY ***
Total pot €0.25 | Rake €0.01
Board [9s 4s 8c 7h 2c]
Seat 1: loudydrix (button) showed [Js 9c] and won (€0.24) with a pair of Nines
Seat 2: C.Guerreiro11 (small blind) folded before Flop
Seat 3: pepedopacio (big blind) folded before Flop
Seat 4: Luckers712 folded before Flop (didn't bet)
Seat 5: Robersaz showed [Kc 5c] and lost with high card King
Seat 6: Pocas Prisas folded before Flop (didn't bet)



PokerStars Zoom Hand #210173853906:  Hold'em No Limit (€0.01/€0.02) - 2020/03/15 20:41:47 CET [2020/03/15 15:41:47 ET]
Table 'Arneb' 6-max Seat #1 is the button
Seat 1: ferran_ambros (€1.75 in chips)
Seat 2: Villano236 (€2 in chips)
Seat 3: jacksparr485 (€2.05 in chips)
Seat 4: alvaroa1888 (€2 in chips)
Seat 5: Luckers712 (€6.99 in chips)
Seat 6: ThePryce (€1 in chips)
Villano236: posts small blind €0.01
jacksparr485: posts big blind €0.02
*** HOLE CARDS ***
Dealt to Luckers712 [2c 6d]
alvaroa1888: raises €0.04 to €0.06
Luckers712: folds
ThePryce: folds
ferran_ambros: calls €0.06
Villano236: folds
jacksparr485: folds
*** FLOP *** [Qd 6h Kc]
alvaroa1888: checks
ferran_ambros: bets €0.02
alvaroa1888: calls €0.02
*** TURN *** [Qd 6h Kc] [4s]
alvaroa1888: checks
ferran_ambros: bets €0.08
alvaroa1888: calls €0.08
*** RIVER *** [Qd 6h Kc 4s] [Ad]
alvaroa1888: checks
ferran_ambros: bets €0.32
alvaroa1888: folds
Uncalled bet (€0.32) returned to ferran_ambros
ferran_ambros collected €0.33 from pot
ferran_ambros: doesn't show hand
*** SUMMARY ***
Total pot €0.35 | Rake €0.02
Board [Qd 6h Kc 4s Ad]
Seat 1: ferran_ambros (button) collected (€0.33)
Seat 2: Villano236 (small blind) folded before Flop
Seat 3: jacksparr485 (big blind) folded before Flop
Seat 4: alvaroa1888 folded on the River
Seat 5: Luckers712 folded before Flop (didn't bet)
Seat 6: ThePryce folded before Flop (didn't bet)



PokerStars Zoom Hand #210173857788:  Hold'em No Limit (€0.01/€0.02) - 2020/03/15 20:41:51 CET [2020/03/15 15:41:51 ET]
Table 'Arneb' 6-max Seat #1 is the button
Seat 1: usskul_44 (€1.26 in chips)
Seat 2: rangerxx11 (€2.34 in chips)
Seat 3: kisko87 (€2 in chips)
Seat 4: serbot131 (€0.54 in chips)
Seat 5: Shikamaru003 (€2.03 in chips)
Seat 6: Luckers712 (€6.99 in chips)
rangerxx11: posts small blind €0.01
kisko87: posts big blind €0.02
*** HOLE CARDS ***
Dealt to Luckers712 [Kc Ks]
serbot131: folds
Shikamaru003: raises €0.03 to €0.05
Luckers712: raises €0.10 to €0.15
usskul_44: folds
rangerxx11: folds
kisko87: folds
Shikamaru003: calls €0.10
*** FLOP *** [2s 6c Qd]
Shikamaru003: checks
Luckers712: checks
*** TURN *** [2s 6c Qd] [6h]
Shikamaru003: bets €0.29
Luckers712: raises €0.41 to €0.70
Shikamaru003: folds
Uncalled bet (€0.41) returned to Luckers712
Luckers712 collected €0.86 from pot
Luckers712: doesn't show hand
*** SUMMARY ***
Total pot €0.91 | Rake €0.05
Board [2s 6c Qd 6h]
Seat 1: usskul_44 (button) folded before Flop (didn't bet)
Seat 2: rangerxx11 (small blind) folded before Flop
Seat 3: kisko87 (big blind) folded before Flop
Seat 4: serbot131 folded before Flop (didn't bet)
Seat 5: Shikamaru003 folded on the Turn
Seat 6: Luckers712 collected (€0.86)



PokerStars Zoom Hand #210173911242:  Hold'em No Limit (€0.01/€0.02) - 2020/03/15 20:42:47 CET [2020/03/15 15:42:47 ET]
Table 'Arneb' 6-max Seat #1 is the button
Seat 1: MaurusT (€2.21 in chips)
Seat 2: Vitorhcsousa (€2.98 in chips)
Seat 3: Luckers712 (€7.41 in chips)
Seat 4: afrodit83 (€0.92 in chips)
Seat 5: ToniMarteens (€0.98 in chips)
Seat 6: Sespir (€3.34 in chips)
Vitorhcsousa: posts small blind €0.01
Luckers712: posts big blind €0.02
*** HOLE CARDS ***
Dealt to Luckers712 [Kd 5d]
afrodit83: folds
ToniMarteens: calls €0.02
Sespir: folds
MaurusT: folds
Vitorhcsousa: folds
Luckers712: checks
*** FLOP *** [4c Tc Qh]
Luckers712: checks
ToniMarteens: checks
*** TURN *** [4c Tc Qh] [4d]
Luckers712: checks
ToniMarteens: checks
*** RIVER *** [4c Tc Qh 4d] [Th]
Luckers712: checks
ToniMarteens: checks
*** SHOW DOWN ***
Luckers712: shows [Kd 5d] (two pair, Tens and Fours)
ToniMarteens: shows [Kh 9h] (two pair, Tens and Fours)
Luckers712 collected €0.03 from pot
ToniMarteens collected €0.02 from pot
*** SUMMARY ***
Total pot €0.05 | Rake €0
Board [4c Tc Qh 4d Th]
Seat 1: MaurusT (button) folded before Flop (didn't bet)
Seat 2: Vitorhcsousa (small blind) folded before Flop
Seat 3: Luckers712 (big blind) showed [Kd 5d] and won (€0.03) with two pair, Tens and Fours
Seat 4: afrodit83 folded before Flop (didn't bet)
Seat 5: ToniMarteens showed [Kh 9h] and won (€0.02) with two pair, Tens and Fours
Seat 6: Sespir folded before Flop (didn't bet)



PokerStars Zoom Hand #210173935239:  Hold'em No Limit (€0.01/€0.02) - 2020/03/15 20:43:12 CET [2020/03/15 15:43:12 ET]
Table 'Arneb' 6-max Seat #1 is the button
Seat 1: WaNtEd_o0 (€1.32 in chips)
Seat 2: Luckers712 (€7.42 in chips)
Seat 3: Borrachoboy (€2 in chips)
Seat 4: talhovsky28 (€2.26 in chips)
Seat 5: 11.M.R.K.11 (€2 in chips)
Seat 6: AgusMamba23 (€2.03 in chips)
Luckers712: posts small blind €0.01
Borrachoboy: posts big blind €0.02
*** HOLE CARDS ***
Dealt to Luckers712 [Td 8c]
talhovsky28: folds
11.M.R.K.11: folds
AgusMamba23: folds
WaNtEd_o0: raises €0.04 to €0.06
Luckers712: folds
Borrachoboy: folds
Uncalled bet (€0.04) returned to WaNtEd_o0
WaNtEd_o0 collected €0.05 from pot
WaNtEd_o0: doesn't show hand
*** SUMMARY ***
Total pot €0.05 | Rake €0
Seat 1: WaNtEd_o0 (button) collected (€0.05)
Seat 2: Luckers712 (small blind) folded before Flop
Seat 3: Borrachoboy (big blind) folded before Flop
Seat 4: talhovsky28 folded before Flop (didn't bet)
Seat 5: 11.M.R.K.11 folded before Flop (didn't bet)
Seat 6: AgusMamba23 folded before Flop (didn't bet)



PokerStars Zoom Hand #210173944765:  Hold'em No Limit (€0.01/€0.02) - 2020/03/15 20:43:22 CET [2020/03/15 15:43:22 ET]
Table 'Arneb' 6-max Seat #1 is the button
Seat 1: Luckers712 (€7.41 in chips)
Seat 2: 11.M.R.K.11 (€2 in chips)
Seat 3: MDKristian (€1.03 in chips)
Seat 4: Veesile (€2.21 in chips)
Seat 5: Borrachoboy (€2 in chips)
Seat 6: sergio475 (€1.84 in chips)
11.M.R.K.11: posts small blind €0.01
MDKristian: posts big blind €0.02
*** HOLE CARDS ***
Dealt to Luckers712 [Ts As]
Veesile: raises €0.03 to €0.05
Borrachoboy: folds
sergio475: raises €0.03 to €0.08
Luckers712: calls €0.08
11.M.R.K.11: folds
MDKristian: folds
Veesile: calls €0.03
*** FLOP *** [3d Kh 6d]
Veesile: checks
sergio475: bets €0.13
Luckers712: folds
Veesile: folds
Uncalled bet (€0.13) returned to sergio475
sergio475 collected €0.26 from pot
sergio475: doesn't show hand
*** SUMMARY ***
Total pot €0.27 | Rake €0.01
Board [3d Kh 6d]
Seat 1: Luckers712 (button) folded on the Flop
Seat 2: 11.M.R.K.11 (small blind) folded before Flop
Seat 3: MDKristian (big blind) folded before Flop
Seat 4: Veesile folded on the Flop
Seat 5: Borrachoboy folded before Flop (didn't bet)
Seat 6: sergio475 collected (€0.26)



PokerStars Zoom Hand #210173973655:  Hold'em No Limit (€0.01/€0.02) - 2020/03/15 20:43:52 CET [2020/03/15 15:43:52 ET]
Table 'Arneb' 6-max Seat #1 is the button
Seat 1: Veesile (€2.21 in chips)
Seat 2: ERIZOCACHO (€3.31 in chips)
Seat 3: rom1derouen (€3.46 in chips)
Seat 4: MaldiniCapitano (€4.54 in chips)
Seat 5: Luckers712 (€7.33 in chips)
Seat 6: Gllaedr (€5.37 in chips)
ERIZOCACHO: posts small blind €0.01
rom1derouen: posts big blind €0.02
*** HOLE CARDS ***
Dealt to Luckers712 [Qs 6h]
MaldiniCapitano: folds
Luckers712: folds
Gllaedr: raises €0.04 to €0.06
Veesile: folds
ERIZOCACHO: folds
rom1derouen: folds
Uncalled bet (€0.04) returned to Gllaedr
Gllaedr collected €0.05 from pot
Gllaedr: doesn't show hand
*** SUMMARY ***
Total pot €0.05 | Rake €0
Seat 1: Veesile (button) folded before Flop (didn't bet)
Seat 2: ERIZOCACHO (small blind) folded before Flop
Seat 3: rom1derouen (big blind) folded before Flop
Seat 4: MaldiniCapitano folded before Flop (didn't bet)
Seat 5: Luckers712 folded before Flop (didn't bet)
Seat 6: Gllaedr collected (€0.05)



PokerStars Zoom Hand #210173977552:  Hold'em No Limit (€0.01/€0.02) - 2020/03/15 20:43:56 CET [2020/03/15 15:43:56 ET]
Table 'Arneb' 6-max Seat #1 is the button
Seat 1: DriztDUrden (€0.98 in chips)
Seat 2: Jagf0010 (€3.24 in chips)
Seat 3: pgraca1972 (€1.48 in chips)
Seat 4: Luckers712 (€7.33 in chips)
Seat 5: durdur311 (€1.71 in chips)
Seat 6: pinneaple4 (€2.84 in chips)
Jagf0010: posts small blind €0.01
pgraca1972: posts big blind €0.02
*** HOLE CARDS ***
Dealt to Luckers712 [Ts 2s]
Luckers712: folds
durdur311: folds
pinneaple4: raises €0.04 to €0.06
DriztDUrden: folds
Jagf0010: raises €0.14 to €0.20
pgraca1972: folds
pinneaple4: raises €0.34 to €0.54
Jagf0010: folds
Uncalled bet (€0.34) returned to pinneaple4
pinneaple4 collected €0.42 from pot
pinneaple4: doesn't show hand
*** SUMMARY ***
Total pot €0.42 | Rake €0
Seat 1: DriztDUrden (button) folded before Flop (didn't bet)
Seat 2: Jagf0010 (small blind) folded before Flop
Seat 3: pgraca1972 (big blind) folded before Flop
Seat 4: Luckers712 folded before Flop (didn't bet)
Seat 5: durdur311 folded before Flop (didn't bet)
Seat 6: pinneaple4 collected (€0.42)



PokerStars Zoom Hand #210173982202:  Hold'em No Limit (€0.01/€0.02) - 2020/03/15 20:44:01 CET [2020/03/15 15:44:01 ET]
Table 'Arneb' 6-max Seat #1 is the button
Seat 1: Venturacamel (€1.39 in chips)
Seat 2: andresrodr8 (€2.06 in chips)
Seat 3: grenyas22 (€6.49 in chips)
Seat 4: Pocas Prisas (€2.46 in chips)
Seat 5: Luckers712 (€7.33 in chips)
Seat 6: 66ocb (€2.92 in chips)
andresrodr8: posts small blind €0.01
grenyas22: posts big blind €0.02
*** HOLE CARDS ***
Dealt to Luckers712 [Ac 2h]
Pocas Prisas: folds
Luckers712: folds
66ocb: raises €0.02 to €0.04
Venturacamel: calls €0.04
andresrodr8: folds
grenyas22: calls €0.02
*** FLOP *** [As 5d 8d]
grenyas22: checks
66ocb: bets €0.02
Venturacamel: calls €0.02
grenyas22: raises €0.08 to €0.10
66ocb: folds
Venturacamel: folds
Uncalled bet (€0.08) returned to grenyas22
grenyas22 collected €0.18 from pot
grenyas22: doesn't show hand
*** SUMMARY ***
Total pot €0.19 | Rake €0.01
Board [As 5d 8d]
Seat 1: Venturacamel (button) folded on the Flop
Seat 2: andresrodr8 (small blind) folded before Flop
Seat 3: grenyas22 (big blind) collected (€0.18)
Seat 4: Pocas Prisas folded before Flop (didn't bet)
Seat 5: Luckers712 folded before Flop (didn't bet)
Seat 6: 66ocb folded on the Flop



PokerStars Zoom Hand #210174016083:  Hold'em No Limit (€0.01/€0.02) - 2020/03/15 20:44:27 CET [2020/03/15 15:44:27 ET]
Table 'Arneb' 6-max Seat #1 is the button
Seat 1: Luckers712 (€7.31 in chips)
Seat 2: andresrodr8 (€2 in chips)
Seat 3: MaurusT (€2.07 in chips)
Seat 4: javigarrido8 (€1.94 in chips)
Seat 5: Borrachoboy (€3.03 in chips)
Seat 6: fcruz91 (€2.12 in chips)
andresrodr8: posts small blind €0.01
MaurusT: posts big blind €0.02
*** HOLE CARDS ***
Dealt to Luckers712 [Kh 3d]
javigarrido8: folds
Borrachoboy: folds
fcruz91: folds
Luckers712: folds
andresrodr8: folds
Uncalled bet (€0.01) returned to MaurusT
MaurusT collected €0.02 from pot
MaurusT: doesn't show hand
*** SUMMARY ***
Total pot €0.02 | Rake €0
Seat 1: Luckers712 (button) folded before Flop (didn't bet)
Seat 2: andresrodr8 (small blind) folded before Flop
Seat 3: MaurusT (big blind) collected (€0.02)
Seat 4: javigarrido8 folded before Flop (didn't bet)
Seat 5: Borrachoboy folded before Flop (didn't bet)
Seat 6: fcruz91 folded before Flop (didn't bet)



PokerStars Zoom Hand #210173985984:  Hold'em No Limit (€0.01/€0.02) - 2020/03/15 20:44:05 CET [2020/03/15 15:44:05 ET]
Table 'Arneb' 6-max Seat #1 is the button
Seat 1: BiggieShoot (€5.20 in chips)
Seat 2: fcruz91 (€4.92 in chips)
Seat 3: Luckers712 (€7.33 in chips)
Seat 4: WaNtEd_o0 (€1.29 in chips)
Seat 5: jose_hdez11 (€2.17 in chips)
Seat 6: roms421984 (€0.58 in chips)
fcruz91: posts small blind €0.01
Luckers712: posts big blind €0.02
*** HOLE CARDS ***
Dealt to Luckers712 [3c 6c]
WaNtEd_o0: folds
jose_hdez11: folds
roms421984: calls €0.02
BiggieShoot: folds
fcruz91: raises €0.06 to €0.08
Luckers712: folds
roms421984: calls €0.06
*** FLOP *** [Jd Kc 5d]
fcruz91: bets €0.08
roms421984: folds
Uncalled bet (€0.08) returned to fcruz91
fcruz91 collected €0.17 from pot
fcruz91: doesn't show hand
*** SUMMARY ***
Total pot €0.18 | Rake €0.01
Board [Jd Kc 5d]
Seat 1: BiggieShoot (button) folded before Flop (didn't bet)
Seat 2: fcruz91 (small blind) collected (€0.17)
Seat 3: Luckers712 (big blind) folded before Flop
Seat 4: WaNtEd_o0 folded before Flop (didn't bet)
Seat 5: jose_hdez11 folded before Flop (didn't bet)
Seat 6: roms421984 folded on the Flop



PokerStars Zoom Hand #210174020732:  Hold'em No Limit (€0.01/€0.02) - 2020/03/15 20:44:32 CET [2020/03/15 15:44:32 ET]
Table 'Arneb' 6-max Seat #1 is the button
Seat 1: so0tas (€1.94 in chips)
Seat 2: Luckers712 (€7.31 in chips)
Seat 3: Frisar (€1.18 in chips)
Seat 4: leoesstc (€1.55 in chips)
Seat 5: Jagf0010 (€3.04 in chips)
Seat 6: PrOdI11 (€14.04 in chips)
Luckers712: posts small blind €0.01
Frisar: posts big blind €0.02
*** HOLE CARDS ***
Dealt to Luckers712 [2d 3s]
leoesstc: folds
Jagf0010: raises €0.04 to €0.06
PrOdI11: folds
so0tas: raises €0.12 to €0.18
Luckers712: folds
Frisar: folds
Jagf0010: folds
Uncalled bet (€0.12) returned to so0tas
so0tas collected €0.15 from pot
so0tas: doesn't show hand
*** SUMMARY ***
Total pot €0.15 | Rake €0
Seat 1: so0tas (button) collected (€0.15)
Seat 2: Luckers712 (small blind) folded before Flop
Seat 3: Frisar (big blind) folded before Flop
Seat 4: leoesstc folded before Flop (didn't bet)
Seat 5: Jagf0010 folded before Flop
Seat 6: PrOdI11 folded before Flop (didn't bet)



PokerStars Zoom Hand #210174030295:  Hold'em No Limit (€0.01/€0.02) - 2020/03/15 20:44:42 CET [2020/03/15 15:44:42 ET]
Table 'Arneb' 6-max Seat #1 is the button
Seat 1: 33TUIGA33 (€0.78 in chips)
Seat 2: durdur311 (€1.61 in chips)
Seat 3: RushRap (€1.26 in chips)
Seat 4: Luckers712 (€7.30 in chips)
Seat 5: Anaheras (€2.49 in chips)
Seat 6: Veesile (€2.37 in chips)
durdur311: posts small blind €0.01
RushRap: posts big blind €0.02
*** HOLE CARDS ***
Dealt to Luckers712 [Ah Kd]
Luckers712: raises €0.03 to €0.05
Anaheras: folds
Veesile: folds
33TUIGA33: folds
durdur311: folds
RushRap: calls €0.03
*** FLOP *** [As 3c Jc]
RushRap: checks
Luckers712: bets €0.05
RushRap: calls €0.05
*** TURN *** [As 3c Jc] [3d]
RushRap: checks
Luckers712: bets €0.10
RushRap: folds
Uncalled bet (€0.10) returned to Luckers712
Luckers712 collected €0.20 from pot
Luckers712: doesn't show hand
*** SUMMARY ***
Total pot €0.21 | Rake €0.01
Board [As 3c Jc 3d]
Seat 1: 33TUIGA33 (button) folded before Flop (didn't bet)
Seat 2: durdur311 (small blind) folded before Flop
Seat 3: RushRap (big blind) folded on the Turn
Seat 4: Luckers712 collected (€0.20)
Seat 5: Anaheras folded before Flop (didn't bet)
Seat 6: Veesile folded before Flop (didn't bet)



PokerStars Zoom Hand #210174026469:  Hold'em No Limit (€0.01/€0.02) - 2020/03/15 20:44:38 CET [2020/03/15 15:44:38 ET]
Table 'Arneb' 6-max Seat #1 is the button
Seat 1: jacksparr485 (€3.61 in chips)
Seat 2: andresrodr8 (€2 in chips)
Seat 3: face_oldie (€1.17 in chips)
Seat 4: lusto09 (€3.29 in chips)
Seat 5: Sweet Answer (€2.19 in chips)
Seat 6: Luckers712 (€7.30 in chips)
andresrodr8: posts small blind €0.01
face_oldie: posts big blind €0.02
*** HOLE CARDS ***
Dealt to Luckers712 [6s Kc]
lusto09: folds
Sweet Answer: raises €0.04 to €0.06
Luckers712: folds
jacksparr485: folds
andresrodr8: folds
face_oldie: raises €0.04 to €0.10
Sweet Answer: calls €0.04
*** FLOP *** [2d 2c 5h]
face_oldie: bets €0.20
Sweet Answer: raises €0.68 to €0.88
face_oldie: raises €0.19 to €1.07 and is all-in
Sweet Answer: calls €0.19
*** TURN *** [2d 2c 5h] [Th]
*** RIVER *** [2d 2c 5h Th] [As]
*** SHOW DOWN ***
face_oldie: shows [6d 6c] (two pair, Sixes and Deuces)
Sweet Answer: shows [3c Ac] (two pair, Aces and Deuces)
Sweet Answer collected €2.23 from pot
*** SUMMARY ***
Total pot €2.35 | Rake €0.12
Board [2d 2c 5h Th As]
Seat 1: jacksparr485 (button) folded before Flop (didn't bet)
Seat 2: andresrodr8 (small blind) folded before Flop
Seat 3: face_oldie (big blind) showed [6d 6c] and lost with two pair, Sixes and Deuces
Seat 4: lusto09 folded before Flop (didn't bet)
Seat 5: Sweet Answer showed [3c Ac] and won (€2.23) with two pair, Aces and Deuces
Seat 6: Luckers712 folded before Flop (didn't bet)



PokerStars Zoom Hand #210174063683:  Hold'em No Limit (€0.01/€0.02) - 2020/03/15 20:45:17 CET [2020/03/15 15:45:17 ET]
Table 'Arneb' 6-max Seat #1 is the button
Seat 1: Anme41 (€1.90 in chips)
Seat 2: ALCINAPIN (€2 in chips)
Seat 3: Luckers712 (€7.40 in chips)
Seat 4: momomokfr (€2.08 in chips)
Seat 5: toine02000 (€2.08 in chips)
Seat 6: serbot131 (€0.25 in chips)
ALCINAPIN: posts small blind €0.01
Luckers712: posts big blind €0.02
*** HOLE CARDS ***
Dealt to Luckers712 [Kh As]
momomokfr: folds
toine02000: folds
serbot131: folds
Anme41: folds
ALCINAPIN: raises €0.04 to €0.06
Luckers712: raises €0.12 to €0.18
ALCINAPIN: raises €0.26 to €0.44
Luckers712: raises €6.96 to €7.40 and is all-in
ALCINAPIN: folds
Uncalled bet (€6.96) returned to Luckers712
Luckers712 collected €0.88 from pot
Luckers712: doesn't show hand
*** SUMMARY ***
Total pot €0.88 | Rake €0
Seat 1: Anme41 (button) folded before Flop (didn't bet)
Seat 2: ALCINAPIN (small blind) folded before Flop
Seat 3: Luckers712 (big blind) collected (€0.88)
Seat 4: momomokfr folded before Flop (didn't bet)
Seat 5: toine02000 folded before Flop (didn't bet)
Seat 6: serbot131 folded before Flop (didn't bet)



PokerStars Zoom Hand #210174058935:  Hold'em No Limit (€0.01/€0.02) - 2020/03/15 20:45:12 CET [2020/03/15 15:45:12 ET]
Table 'Arneb' 6-max Seat #1 is the button
Seat 1: Sespir (€3.18 in chips)
Seat 2: fergram2020 (€2.95 in chips)
Seat 3: jl le canari (€1.96 in chips)
Seat 4: Luckers712 (€7.40 in chips)
Seat 5: maritz12 (€2.01 in chips)
Seat 6: Pocas Prisas (€2.50 in chips)
fergram2020: posts small blind €0.01
jl le canari: posts big blind €0.02
*** HOLE CARDS ***
Dealt to Luckers712 [Ah 2d]
Luckers712: folds
maritz12: folds
Pocas Prisas: folds
Sespir: raises €0.04 to €0.06
fergram2020: calls €0.05
jl le canari: calls €0.04
*** FLOP *** [Kc 9s 6h]
fergram2020: checks
jl le canari: checks
Sespir: checks
*** TURN *** [Kc 9s 6h] [5c]
fergram2020: bets €0.02
jl le canari: folds
Sespir: calls €0.02
*** RIVER *** [Kc 9s 6h 5c] [8h]
fergram2020: bets €0.02
Sespir: calls €0.02
*** SHOW DOWN ***
fergram2020: shows [9d Qh] (a pair of Nines)
Sespir: mucks hand
fergram2020 collected €0.25 from pot
*** SUMMARY ***
Total pot €0.26 | Rake €0.01
Board [Kc 9s 6h 5c 8h]
Seat 1: Sespir (button) mucked [Qc Jd]
Seat 2: fergram2020 (small blind) showed [9d Qh] and won (€0.25) with a pair of Nines
Seat 3: jl le canari (big blind) folded on the Turn
Seat 4: Luckers712 folded before Flop (didn't bet)
Seat 5: maritz12 folded before Flop (didn't bet)
Seat 6: Pocas Prisas folded before Flop (didn't bet)



PokerStars Zoom Hand #210174104508:  Hold'em No Limit (€0.01/€0.02) - 2020/03/15 20:46:00 CET [2020/03/15 15:46:00 ET]
Table 'Arneb' 6-max Seat #1 is the button
Seat 1: alvaroa1888 (€2 in chips)
Seat 2: Luckers712 (€7.84 in chips)
Seat 3: levdudinES (€4.38 in chips)
Seat 4: maritz12 (€2 in chips)
Seat 5: Veesile (€2.39 in chips)
Seat 6: TheShrimp8 (€2.46 in chips)
Luckers712: posts small blind €0.01
levdudinES: posts big blind €0.02
*** HOLE CARDS ***
Dealt to Luckers712 [Qh Ts]
maritz12: folds
Veesile: folds
TheShrimp8: raises €0.04 to €0.06
alvaroa1888: folds
Luckers712: folds
levdudinES: folds
Uncalled bet (€0.04) returned to TheShrimp8
TheShrimp8 collected €0.05 from pot
TheShrimp8: doesn't show hand
*** SUMMARY ***
Total pot €0.05 | Rake €0
Seat 1: alvaroa1888 (button) folded before Flop (didn't bet)
Seat 2: Luckers712 (small blind) folded before Flop
Seat 3: levdudinES (big blind) folded before Flop
Seat 4: maritz12 folded before Flop (didn't bet)
Seat 5: Veesile folded before Flop (didn't bet)
Seat 6: TheShrimp8 collected (€0.05)



PokerStars Zoom Hand #210174116716:  Hold'em No Limit (€0.01/€0.02) - 2020/03/15 20:46:13 CET [2020/03/15 15:46:13 ET]
Table 'Arneb' 6-max Seat #1 is the button
Seat 1: eslavoneslavon (€2.35 in chips)
Seat 2: nellussus (€2.03 in chips)
Seat 3: djonybrowns (€2.13 in chips)
Seat 4: moreno7080 (€0.98 in chips)
Seat 5: jl le canari (€1.92 in chips)
Seat 6: Luckers712 (€7.83 in chips)
nellussus: posts small blind €0.01
djonybrowns: posts big blind €0.02
*** HOLE CARDS ***
Dealt to Luckers712 [Qs Qc]
moreno7080: calls €0.02
jl le canari: folds
Luckers712: raises €0.04 to €0.06
eslavoneslavon: calls €0.06
nellussus: folds
djonybrowns: folds
moreno7080: calls €0.04
*** FLOP *** [Kc 5h 4c]
moreno7080: checks
Luckers712: checks
eslavoneslavon: checks
*** TURN *** [Kc 5h 4c] [Kd]
moreno7080: bets €0.10
Luckers712: calls €0.10
eslavoneslavon: folds
*** RIVER *** [Kc 5h 4c Kd] [Ks]
moreno7080: bets €0.20
Luckers712: calls €0.20
*** SHOW DOWN ***
moreno7080: shows [Td Th] (a full house, Kings full of Tens)
Luckers712: shows [Qs Qc] (a full house, Kings full of Queens)
Luckers712 collected €0.77 from pot
*** SUMMARY ***
Total pot €0.81 | Rake €0.04
Board [Kc 5h 4c Kd Ks]
Seat 1: eslavoneslavon (button) folded on the Turn
Seat 2: nellussus (small blind) folded before Flop
Seat 3: djonybrowns (big blind) folded before Flop
Seat 4: moreno7080 showed [Td Th] and lost with a full house, Kings full of Tens
Seat 5: jl le canari folded before Flop (didn't bet)
Seat 6: Luckers712 showed [Qs Qc] and won (€0.77) with a full house, Kings full of Queens



PokerStars Zoom Hand #210174164465:  Hold'em No Limit (€0.01/€0.02) - 2020/03/15 20:47:03 CET [2020/03/15 15:47:03 ET]
Table 'Arneb' 6-max Seat #1 is the button
Seat 1: Luckers712 (€8.24 in chips)
Seat 2: hermagar (€2.65 in chips)
Seat 3: 33TUIGA33 (€1.32 in chips)
Seat 4: Daficko (€1.64 in chips)
Seat 5: serafin1824 (€1.29 in chips)
Seat 6: Delia7592 (€1.04 in chips)
hermagar: posts small blind €0.01
33TUIGA33: posts big blind €0.02
*** HOLE CARDS ***
Dealt to Luckers712 [Jd 7h]
Daficko: calls €0.02
serafin1824: folds
Delia7592: raises €0.60 to €0.62
Luckers712: folds
hermagar: folds
33TUIGA33: folds
Daficko: folds
Uncalled bet (€0.60) returned to Delia7592
Delia7592 collected €0.07 from pot
Delia7592: doesn't show hand
*** SUMMARY ***
Total pot €0.07 | Rake €0
Seat 1: Luckers712 (button) folded before Flop (didn't bet)
Seat 2: hermagar (small blind) folded before Flop
Seat 3: 33TUIGA33 (big blind) folded before Flop
Seat 4: Daficko folded before Flop
Seat 5: serafin1824 folded before Flop (didn't bet)
Seat 6: Delia7592 collected (€0.07)



PokerStars Zoom Hand #210174168204:  Hold'em No Limit (€0.01/€0.02) - 2020/03/15 20:47:07 CET [2020/03/15 15:47:07 ET]
Table 'Arneb' 6-max Seat #1 is the button
Seat 1: loudydrix (€1.76 in chips)
Seat 2: Aleksifr (€4.30 in chips)
Seat 3: Luckers712 (€8.24 in chips)
Seat 4: Veesile (€2.29 in chips)
Seat 5: levdudinES (€4.33 in chips)
Seat 6: unounoporfavor (€2.30 in chips)
Aleksifr: posts small blind €0.01
Luckers712: posts big blind €0.02
*** HOLE CARDS ***
Dealt to Luckers712 [Th 8s]
Veesile: folds
levdudinES: folds
unounoporfavor: raises €0.02 to €0.04
loudydrix: calls €0.04
Aleksifr: calls €0.03
Luckers712: calls €0.02
*** FLOP *** [Tc Qc Kc]
Aleksifr: checks
Luckers712: checks
unounoporfavor: bets €0.06
loudydrix: raises €0.27 to €0.33
Aleksifr: folds
Luckers712: folds
unounoporfavor: folds
Uncalled bet (€0.27) returned to loudydrix
loudydrix collected €0.27 from pot
loudydrix: doesn't show hand
*** SUMMARY ***
Total pot €0.28 | Rake €0.01
Board [Tc Qc Kc]
Seat 1: loudydrix (button) collected (€0.27)
Seat 2: Aleksifr (small blind) folded on the Flop
Seat 3: Luckers712 (big blind) folded on the Flop
Seat 4: Veesile folded before Flop (didn't bet)
Seat 5: levdudinES folded before Flop (didn't bet)
Seat 6: unounoporfavor folded on the Flop



PokerStars Zoom Hand #210174159747:  Hold'em No Limit (€0.01/€0.02) - 2020/03/15 20:46:58 CET [2020/03/15 15:46:58 ET]
Table 'Arneb' 6-max Seat #1 is the button
Seat 1: mikolapiz1 (€2.07 in chips)
Seat 2: marbad19 (€2.59 in chips)
Seat 3: Veesile (€2 in chips)
Seat 4: filipasrl (€0.25 in chips)
Seat 5: Luckers712 (€8.24 in chips)
Seat 6: Borrachoboy (€2.04 in chips)
marbad19: posts small blind €0.01
Veesile: posts big blind €0.02
*** HOLE CARDS ***
Dealt to Luckers712 [7s 3s]
filipasrl: folds
Luckers712: folds
Borrachoboy: raises €0.04 to €0.06
mikolapiz1: folds
marbad19: calls €0.05
Veesile: folds
*** FLOP *** [2c Td 7c]
marbad19: checks
Borrachoboy: checks
*** TURN *** [2c Td 7c] [4h]
marbad19: bets €0.12
Borrachoboy: calls €0.12
*** RIVER *** [2c Td 7c 4h] [8h]
marbad19: bets €0.23
Borrachoboy: calls €0.23
*** SHOW DOWN ***
marbad19: shows [9c 8c] (a pair of Eights)
Borrachoboy: shows [Js Jd] (a pair of Jacks)
Borrachoboy collected €0.80 from pot
*** SUMMARY ***
Total pot €0.84 | Rake €0.04
Board [2c Td 7c 4h 8h]
Seat 1: mikolapiz1 (button) folded before Flop (didn't bet)
Seat 2: marbad19 (small blind) showed [9c 8c] and lost with a pair of Eights
Seat 3: Veesile (big blind) folded before Flop
Seat 4: filipasrl folded before Flop (didn't bet)
Seat 5: Luckers712 folded before Flop (didn't bet)
Seat 6: Borrachoboy showed [Js Jd] and won (€0.80) with a pair of Jacks



PokerStars Zoom Hand #210174197809:  Hold'em No Limit (€0.01/€0.02) - 2020/03/15 20:47:38 CET [2020/03/15 15:47:38 ET]
Table 'Arneb' 6-max Seat #1 is the button
Seat 1: fanfan81648 (€2.80 in chips)
Seat 2: TheShrimp8 (€2.34 in chips)
Seat 3: fcruz91 (€1.64 in chips)
Seat 4: maritz12 (€4.02 in chips)
Seat 5: Franç@ (€14.49 in chips)
Seat 6: Luckers712 (€8.20 in chips)
TheShrimp8: posts small blind €0.01
fcruz91: posts big blind €0.02
*** HOLE CARDS ***
Dealt to Luckers712 [3d 8s]
maritz12: folds
Franç@: folds
Luckers712: folds
fanfan81648: raises €0.02 to €0.04
TheShrimp8: folds
fcruz91: folds
Uncalled bet (€0.02) returned to fanfan81648
fanfan81648 collected €0.05 from pot
fanfan81648: doesn't show hand
*** SUMMARY ***
Total pot €0.05 | Rake €0
Seat 1: fanfan81648 (button) collected (€0.05)
Seat 2: TheShrimp8 (small blind) folded before Flop
Seat 3: fcruz91 (big blind) folded before Flop
Seat 4: maritz12 folded before Flop (didn't bet)
Seat 5: Franç@ folded before Flop (didn't bet)
Seat 6: Luckers712 folded before Flop (didn't bet)



PokerStars Zoom Hand #210174206206:  Hold'em No Limit (€0.01/€0.02) - 2020/03/15 20:47:47 CET [2020/03/15 15:47:47 ET]
Table 'Arneb' 6-max Seat #1 is the button
Seat 1: raffiki365 (€1.76 in chips)
Seat 2: Luckers712 (€8.20 in chips)
Seat 3: edusupra (€1 in chips)
Seat 4: ElvasSniper (€2 in chips)
Seat 5: guigen06 (€2.14 in chips)
Seat 6: Vitorhcsousa (€5.74 in chips)
Luckers712: posts small blind €0.01
edusupra: posts big blind €0.02
*** HOLE CARDS ***
Dealt to Luckers712 [9d 6c]
ElvasSniper: folds
guigen06: folds
Vitorhcsousa: folds
raffiki365: folds
Luckers712: folds
Uncalled bet (€0.01) returned to edusupra
edusupra collected €0.02 from pot
edusupra: doesn't show hand
*** SUMMARY ***
Total pot €0.02 | Rake €0
Seat 1: raffiki365 (button) folded before Flop (didn't bet)
Seat 2: Luckers712 (small blind) folded before Flop
Seat 3: edusupra (big blind) collected (€0.02)
Seat 4: ElvasSniper folded before Flop (didn't bet)
Seat 5: guigen06 folded before Flop (didn't bet)
Seat 6: Vitorhcsousa folded before Flop (didn't bet)



PokerStars Zoom Hand #210174201424:  Hold'em No Limit (€0.01/€0.02) - 2020/03/15 20:47:42 CET [2020/03/15 15:47:42 ET]
Table 'Arneb' 6-max Seat #1 is the button
Seat 1: Luckers712 (€8.20 in chips)
Seat 2: BiggieShoot (€4.21 in chips)
Seat 3: saulb16 (€2 in chips)
Seat 4: ferran_ambros (€2.28 in chips)
Seat 5: Villano236 (€2.19 in chips)
Seat 6: Veesile (€2.37 in chips)
BiggieShoot: posts small blind €0.01
saulb16: posts big blind €0.02
*** HOLE CARDS ***
Dealt to Luckers712 [5s 6c]
ferran_ambros: calls €0.02
Villano236: raises €0.06 to €0.08
Veesile: folds
Luckers712: folds
BiggieShoot: folds
saulb16: folds
ferran_ambros: folds
Uncalled bet (€0.06) returned to Villano236
Villano236 collected €0.07 from pot
Villano236: doesn't show hand
*** SUMMARY ***
Total pot €0.07 | Rake €0
Seat 1: Luckers712 (button) folded before Flop (didn't bet)
Seat 2: BiggieShoot (small blind) folded before Flop
Seat 3: saulb16 (big blind) folded before Flop
Seat 4: ferran_ambros folded before Flop
Seat 5: Villano236 collected (€0.07)
Seat 6: Veesile folded before Flop (didn't bet)



PokerStars Zoom Hand #210174210034:  Hold'em No Limit (€0.01/€0.02) - 2020/03/15 20:47:51 CET [2020/03/15 15:47:51 ET]
Table 'Arneb' 6-max Seat #1 is the button
Seat 1: neolha (€4.13 in chips)
Seat 2: MaurusT (€1.88 in chips)
Seat 3: momomokfr (€2 in chips)
Seat 4: cybernuno (€0.97 in chips)
Seat 5: Luckers712 (€8.19 in chips)
Seat 6: spuma18 (€3.10 in chips)
MaurusT: posts small blind €0.01
momomokfr: posts big blind €0.02
*** HOLE CARDS ***
Dealt to Luckers712 [3c 9h]
cybernuno: raises €0.04 to €0.06
Luckers712: folds
spuma18: folds
neolha: folds
MaurusT: folds
momomokfr: folds
Uncalled bet (€0.04) returned to cybernuno
cybernuno collected €0.05 from pot
cybernuno: doesn't show hand
*** SUMMARY ***
Total pot €0.05 | Rake €0
Seat 1: neolha (button) folded before Flop (didn't bet)
Seat 2: MaurusT (small blind) folded before Flop
Seat 3: momomokfr (big blind) folded before Flop
Seat 4: cybernuno collected (€0.05)
Seat 5: Luckers712 folded before Flop (didn't bet)
Seat 6: spuma18 folded before Flop (didn't bet)



PokerStars Zoom Hand #210174213836:  Hold'em No Limit (€0.01/€0.02) - 2020/03/15 20:47:55 CET [2020/03/15 15:47:55 ET]
Table 'Arneb' 6-max Seat #1 is the button
Seat 1: TheShrimp8 (€2.33 in chips)
Seat 2: Jagf0010 (€4.78 in chips)
Seat 3: Borrachoboy (€2 in chips)
Seat 4: Luckers712 (€8.19 in chips)
Seat 5: puma452 (€3.11 in chips)
Seat 6: andresrodr8 (€2.20 in chips)
Jagf0010: posts small blind €0.01
Borrachoboy: posts big blind €0.02
*** HOLE CARDS ***
Dealt to Luckers712 [5d Jd]
Luckers712: folds
puma452: folds
andresrodr8: folds
TheShrimp8: raises €0.03 to €0.05
Jagf0010: folds
Borrachoboy: calls €0.03
*** FLOP *** [2c 8d 6d]
Borrachoboy: checks
TheShrimp8: bets €0.08
Borrachoboy: calls €0.08
*** TURN *** [2c 8d 6d] [Kc]
Borrachoboy: checks
TheShrimp8: checks
*** RIVER *** [2c 8d 6d Kc] [2h]
Borrachoboy: checks
TheShrimp8: checks
*** SHOW DOWN ***
Borrachoboy: shows [7c 7d] (two pair, Sevens and Deuces)
TheShrimp8: shows [Tc Th] (two pair, Tens and Deuces)
TheShrimp8 collected €0.26 from pot
*** SUMMARY ***
Total pot €0.27 | Rake €0.01
Board [2c 8d 6d Kc 2h]
Seat 1: TheShrimp8 (button) showed [Tc Th] and won (€0.26) with two pair, Tens and Deuces
Seat 2: Jagf0010 (small blind) folded before Flop
Seat 3: Borrachoboy (big blind) showed [7c 7d] and lost with two pair, Sevens and Deuces
Seat 4: Luckers712 folded before Flop (didn't bet)
Seat 5: puma452 folded before Flop (didn't bet)
Seat 6: andresrodr8 folded before Flop (didn't bet)



PokerStars Zoom Hand #210174218446:  Hold'em No Limit (€0.01/€0.02) - 2020/03/15 20:48:00 CET [2020/03/15 15:48:00 ET]
Table 'Arneb' 6-max Seat #1 is the button
Seat 1: popipat (€2.28 in chips)
Seat 2: fanfan81648 (€2.83 in chips)
Seat 3: Luckers712 (€8.19 in chips)
Seat 4: A8kill (€2.54 in chips)
Seat 5: ricmp (€5.17 in chips)
Seat 6: kikopt93 (€0.97 in chips)
fanfan81648: posts small blind €0.01
Luckers712: posts big blind €0.02
*** HOLE CARDS ***
Dealt to Luckers712 [Ah 5h]
A8kill: calls €0.02
ricmp: folds
kikopt93: calls €0.02
popipat: folds
fanfan81648: folds
Luckers712: checks
*** FLOP *** [Jc Ks 3d]
Luckers712: checks
A8kill: checks
kikopt93: checks
*** TURN *** [Jc Ks 3d] [4s]
Luckers712: checks
A8kill: bets €0.05
kikopt93: calls €0.05
Luckers712: folds
*** RIVER *** [Jc Ks 3d 4s] [6s]
A8kill: checks
kikopt93: checks
*** SHOW DOWN ***
A8kill: shows [Td Js] (a pair of Jacks)
kikopt93: mucks hand
A8kill collected €0.16 from pot
*** SUMMARY ***
Total pot €0.17 | Rake €0.01
Board [Jc Ks 3d 4s 6s]
Seat 1: popipat (button) folded before Flop (didn't bet)
Seat 2: fanfan81648 (small blind) folded before Flop
Seat 3: Luckers712 (big blind) folded on the Turn
Seat 4: A8kill showed [Td Js] and won (€0.16) with a pair of Jacks
Seat 5: ricmp folded before Flop (didn't bet)
Seat 6: kikopt93 mucked [6c 5d]



PokerStars Zoom Hand #210174273640:  Hold'em No Limit (€0.01/€0.02) - 2020/03/15 20:48:58 CET [2020/03/15 15:48:58 ET]
Table 'Arneb' 6-max Seat #1 is the button
Seat 1: A8kill (€2.63 in chips)
Seat 2: Villano236 (€3.22 in chips)
Seat 3: TheShrimp8 (€2.28 in chips)
Seat 4: Luckers712 (€8.17 in chips)
Seat 5: TIBO4137 (€1.70 in chips)
Seat 6: ricmp (€4.61 in chips)
Villano236: posts small blind €0.01
TheShrimp8: posts big blind €0.02
*** HOLE CARDS ***
Dealt to Luckers712 [7c 8c]
Luckers712: raises €0.04 to €0.06
TIBO4137: folds
ricmp: raises €0.12 to €0.18
A8kill: folds
Villano236: folds
TheShrimp8: folds
Luckers712: folds
Uncalled bet (€0.12) returned to ricmp
ricmp collected €0.15 from pot
*** SUMMARY ***
Total pot €0.15 | Rake €0
Seat 1: A8kill (button) folded before Flop (didn't bet)
Seat 2: Villano236 (small blind) folded before Flop
Seat 3: TheShrimp8 (big blind) folded before Flop
Seat 4: Luckers712 folded before Flop
Seat 5: TIBO4137 folded before Flop (didn't bet)
Seat 6: ricmp collected (€0.15)



PokerStars Zoom Hand #210174287857:  Hold'em No Limit (€0.01/€0.02) - 2020/03/15 20:49:13 CET [2020/03/15 15:49:13 ET]
Table 'Arneb' 6-max Seat #1 is the button
Seat 1: TheShrimp8 (€2.26 in chips)
Seat 2: BamBol2 (€3.91 in chips)
Seat 3: lusto09 (€8.89 in chips)
Seat 4: DriztDUrden (€1.26 in chips)
Seat 5: bulhacu (€1.43 in chips)
Seat 6: Luckers712 (€8.11 in chips)
BamBol2: posts small blind €0.01
lusto09: posts big blind €0.02
*** HOLE CARDS ***
Dealt to Luckers712 [2h 9s]
DriztDUrden: folds
bulhacu: raises €0.04 to €0.06
Luckers712: folds
TheShrimp8: folds
BamBol2: calls €0.05
lusto09: folds
*** FLOP *** [Kh 9c 4s]
BamBol2: checks
bulhacu: bets €0.07
BamBol2: calls €0.07
*** TURN *** [Kh 9c 4s] [Td]
BamBol2: checks
bulhacu: bets €0.14
BamBol2: calls €0.14
*** RIVER *** [Kh 9c 4s Td] [5h]
BamBol2: checks
bulhacu: checks
*** SHOW DOWN ***
BamBol2: shows [Tc Qc] (a pair of Tens)
bulhacu: mucks hand
BamBol2 collected €0.53 from pot
*** SUMMARY ***
Total pot €0.56 | Rake €0.03
Board [Kh 9c 4s Td 5h]
Seat 1: TheShrimp8 (button) folded before Flop (didn't bet)
Seat 2: BamBol2 (small blind) showed [Tc Qc] and won (€0.53) with a pair of Tens
Seat 3: lusto09 (big blind) folded before Flop
Seat 4: DriztDUrden folded before Flop (didn't bet)
Seat 5: bulhacu mucked [Ts 8s]
Seat 6: Luckers712 folded before Flop (didn't bet)



PokerStars Zoom Hand #210174292492:  Hold'em No Limit (€0.01/€0.02) - 2020/03/15 20:49:18 CET [2020/03/15 15:49:18 ET]
Table 'Arneb' 6-max Seat #1 is the button
Seat 1: Veesile (€2.38 in chips)
Seat 2: Luckers712 (€8.11 in chips)
Seat 3: ERIZOCACHO (€1.38 in chips)
Seat 4: MORENODCADI (€1.67 in chips)
Seat 5: BiggieShoot (€5.16 in chips)
Seat 6: agomez0905 (€2.31 in chips)
Luckers712: posts small blind €0.01
ERIZOCACHO: posts big blind €0.02
*** HOLE CARDS ***
Dealt to Luckers712 [5c 8c]
MORENODCADI: raises €0.04 to €0.06
BiggieShoot: folds
agomez0905: folds
Veesile: folds
Luckers712: raises €0.12 to €0.18
ERIZOCACHO: folds
MORENODCADI: calls €0.12
*** FLOP *** [2c 7c Th]
Luckers712: checks
MORENODCADI: bets €0.32
Luckers712: calls €0.32
*** TURN *** [2c 7c Th] [Qh]
Luckers712: checks
MORENODCADI: checks
*** RIVER *** [2c 7c Th Qh] [Jd]
Luckers712: checks
MORENODCADI: bets €0.49
Luckers712: folds
Uncalled bet (€0.49) returned to MORENODCADI
MORENODCADI collected €0.97 from pot
*** SUMMARY ***
Total pot €1.02 | Rake €0.05
Board [2c 7c Th Qh Jd]
Seat 1: Veesile (button) folded before Flop (didn't bet)
Seat 2: Luckers712 (small blind) folded on the River
Seat 3: ERIZOCACHO (big blind) folded before Flop
Seat 4: MORENODCADI collected (€0.97)
Seat 5: BiggieShoot folded before Flop (didn't bet)
Seat 6: agomez0905 folded before Flop (didn't bet)



PokerStars Zoom Hand #210174397697:  Hold'em No Limit (€0.01/€0.02) - 2020/03/15 20:51:10 CET [2020/03/15 15:51:10 ET]
Table 'Arneb' 6-max Seat #1 is the button
Seat 1: !JAT!989 (€4.17 in chips)
Seat 2: Jans2011 (€3.18 in chips)
Seat 3: 1995almeida71 (€0.49 in chips)
Seat 4: rom1derouen (€3.50 in chips)
Seat 5: Luckers712 (€7.61 in chips)
Seat 6: Pocas Prisas (€4.74 in chips)
Jans2011: posts small blind €0.01
1995almeida71: posts big blind €0.02
*** HOLE CARDS ***
Dealt to Luckers712 [3c Jd]
rom1derouen: folds
Luckers712: folds
Pocas Prisas: folds
!JAT!989: raises €0.06 to €0.08
Jans2011: folds
1995almeida71: folds
Uncalled bet (€0.06) returned to !JAT!989
!JAT!989 collected €0.05 from pot
!JAT!989: doesn't show hand
*** SUMMARY ***
Total pot €0.05 | Rake €0
Seat 1: !JAT!989 (button) collected (€0.05)
Seat 2: Jans2011 (small blind) folded before Flop
Seat 3: 1995almeida71 (big blind) folded before Flop
Seat 4: rom1derouen folded before Flop (didn't bet)
Seat 5: Luckers712 folded before Flop (didn't bet)
Seat 6: Pocas Prisas folded before Flop (didn't bet)



PokerStars Zoom Hand #210174401580:  Hold'em No Limit (€0.01/€0.02) - 2020/03/15 20:51:14 CET [2020/03/15 15:51:14 ET]
Table 'Arneb' 6-max Seat #1 is the button
Seat 1: Gllaedr (€1.77 in chips)
Seat 2: cybernuno (€1 in chips)
Seat 3: BiggieShoot (€5.22 in chips)
Seat 4: Luckers712 (€7.61 in chips)
Seat 5: loudydrix (€1.32 in chips)
Seat 6: TINO TIMBA (€2.11 in chips)
cybernuno: posts small blind €0.01
BiggieShoot: posts big blind €0.02
*** HOLE CARDS ***
Dealt to Luckers712 [Qs 2d]
Luckers712: folds
loudydrix: folds
TINO TIMBA: folds
Gllaedr: raises €0.04 to €0.06
cybernuno: folds
BiggieShoot: folds
Uncalled bet (€0.04) returned to Gllaedr
Gllaedr collected €0.05 from pot
Gllaedr: doesn't show hand
*** SUMMARY ***
Total pot €0.05 | Rake €0
Seat 1: Gllaedr (button) collected (€0.05)
Seat 2: cybernuno (small blind) folded before Flop
Seat 3: BiggieShoot (big blind) folded before Flop
Seat 4: Luckers712 folded before Flop (didn't bet)
Seat 5: loudydrix folded before Flop (didn't bet)
Seat 6: TINO TIMBA folded before Flop (didn't bet)



PokerStars Zoom Hand #210174408205:  Hold'em No Limit (€0.01/€0.02) - 2020/03/15 20:51:21 CET [2020/03/15 15:51:21 ET]
Table 'Arneb' 6-max Seat #1 is the button
Seat 1: LCA54 (€1.96 in chips)
Seat 2: talhovsky28 (€1.98 in chips)
Seat 3: Luckers712 (€7.61 in chips)
Seat 4: loudydrix (€1.32 in chips)
Seat 5: Pocas Prisas (€3.65 in chips)
Seat 6: ALCINAPIN (€2.12 in chips)
talhovsky28: posts small blind €0.01
Luckers712: posts big blind €0.02
*** HOLE CARDS ***
Dealt to Luckers712 [Kh 9d]
loudydrix: folds
Pocas Prisas: raises €0.06 to €0.08
ALCINAPIN: folds
LCA54: folds
talhovsky28: folds
Luckers712: folds
Uncalled bet (€0.06) returned to Pocas Prisas
Pocas Prisas collected €0.05 from pot
*** SUMMARY ***
Total pot €0.05 | Rake €0
Seat 1: LCA54 (button) folded before Flop (didn't bet)
Seat 2: talhovsky28 (small blind) folded before Flop
Seat 3: Luckers712 (big blind) folded before Flop
Seat 4: loudydrix folded before Flop (didn't bet)
Seat 5: Pocas Prisas collected (€0.05)
Seat 6: ALCINAPIN folded before Flop (didn't bet)



PokerStars Zoom Hand #210174419552:  Hold'em No Limit (€0.01/€0.02) - 2020/03/15 20:51:33 CET [2020/03/15 15:51:33 ET]
Table 'Arneb' 6-max Seat #1 is the button
Seat 1: romex0 (€2.75 in chips)
Seat 2: so0tas (€2 in chips)
Seat 3: slof14 (€2.95 in chips)
Seat 4: Luckers712 (€7.59 in chips)
Seat 5: Villano236 (€3.16 in chips)
Seat 6: Seron1023 (€2.83 in chips)
so0tas: posts small blind €0.01
slof14: posts big blind €0.02
*** HOLE CARDS ***
Dealt to Luckers712 [Kd Jh]
Luckers712: raises €0.03 to €0.05
Villano236: folds
Seron1023: folds
romex0: folds
so0tas: folds
slof14: folds
Uncalled bet (€0.03) returned to Luckers712
Luckers712 collected €0.05 from pot
Luckers712: doesn't show hand
*** SUMMARY ***
Total pot €0.05 | Rake €0
Seat 1: romex0 (button) folded before Flop (didn't bet)
Seat 2: so0tas (small blind) folded before Flop
Seat 3: slof14 (big blind) folded before Flop
Seat 4: Luckers712 collected (€0.05)
Seat 5: Villano236 folded before Flop (didn't bet)
Seat 6: Seron1023 folded before Flop (didn't bet)



PokerStars Zoom Hand #210174393012:  Hold'em No Limit (€0.01/€0.02) - 2020/03/15 20:51:05 CET [2020/03/15 15:51:05 ET]
Table 'Arneb' 6-max Seat #1 is the button
Seat 1: Luckers712 (€7.61 in chips)
Seat 2: trimppperator0 (€2.77 in chips)
Seat 3: Baylins11 (€0.02 in chips)
Seat 4: TINO TIMBA (€2.11 in chips)
Seat 5: jacksparr485 (€3.86 in chips)
Seat 6: Borrachoboy (€2 in chips)
trimppperator0: posts small blind €0.01
Baylins11: posts big blind €0.02 and is all-in
*** HOLE CARDS ***
Dealt to Luckers712 [7c 4s]
TINO TIMBA: folds
jacksparr485: raises €0.04 to €0.06
Borrachoboy: raises €0.12 to €0.18
Luckers712: folds
trimppperator0: folds
jacksparr485: calls €0.12
*** FLOP *** [5h Qh Ks]
jacksparr485: checks
Borrachoboy: bets €0.25
jacksparr485: calls €0.25
*** TURN *** [5h Qh Ks] [Js]
jacksparr485: checks
Borrachoboy: bets €0.55
jacksparr485: raises €2.88 to €3.43 and is all-in
Borrachoboy: calls €1.02 and is all-in
Uncalled bet (€1.86) returned to jacksparr485
*** RIVER *** [5h Qh Ks Js] [Ac]
*** SHOW DOWN ***
jacksparr485: shows [Jd Qd] (two pair, Queens and Jacks)
Borrachoboy: shows [Kh Kc] (three of a kind, Kings)
Borrachoboy collected €3.76 from side pot
Baylins11: shows [9s As] (a pair of Aces)
Borrachoboy collected €0.07 from main pot
*** SUMMARY ***
Total pot €4.03 Main pot €0.07. Side pot €3.76. | Rake €0.20
Board [5h Qh Ks Js Ac]
Seat 1: Luckers712 (button) folded before Flop (didn't bet)
Seat 2: trimppperator0 (small blind) folded before Flop
Seat 3: Baylins11 (big blind) showed [9s As] and lost with a pair of Aces
Seat 4: TINO TIMBA folded before Flop (didn't bet)
Seat 5: jacksparr485 showed [Jd Qd] and lost with two pair, Queens and Jacks
Seat 6: Borrachoboy showed [Kh Kc] and won (€3.83) with three of a kind, Kings



PokerStars Zoom Hand #210174430631:  Hold'em No Limit (€0.01/€0.02) - 2020/03/15 20:51:45 CET [2020/03/15 15:51:45 ET]
Table 'Arneb' 6-max Seat #1 is the button
Seat 1: javigarrido8 (€0.99 in chips)
Seat 2: Luckers712 (€7.62 in chips)
Seat 3: Jagf0010 (€10.13 in chips)
Seat 4: unounoporfavor (€4.51 in chips)
Seat 5: Gllaedr (€3.39 in chips)
Seat 6: sergio475 (€2.86 in chips)
Luckers712: posts small blind €0.01
Jagf0010: posts big blind €0.02
*** HOLE CARDS ***
Dealt to Luckers712 [Jh 7c]
unounoporfavor: folds
Gllaedr: folds
sergio475: folds
javigarrido8: folds
Luckers712: folds
Uncalled bet (€0.01) returned to Jagf0010
Jagf0010 collected €0.02 from pot
Jagf0010: doesn't show hand
*** SUMMARY ***
Total pot €0.02 | Rake €0
Seat 1: javigarrido8 (button) folded before Flop (didn't bet)
Seat 2: Luckers712 (small blind) folded before Flop
Seat 3: Jagf0010 (big blind) collected (€0.02)
Seat 4: unounoporfavor folded before Flop (didn't bet)
Seat 5: Gllaedr folded before Flop (didn't bet)
Seat 6: sergio475 folded before Flop (didn't bet)



PokerStars Zoom Hand #210174439967:  Hold'em No Limit (€0.01/€0.02) - 2020/03/15 20:51:55 CET [2020/03/15 15:51:55 ET]
Table 'Arneb' 6-max Seat #1 is the button
Seat 1: Luckers712 (€7.61 in chips)
Seat 2: maritz12 (€4.63 in chips)
Seat 3: alvaroa1888 (€2.14 in chips)
Seat 4: Benoît S (€2.75 in chips)
Seat 5: pinpanculos (€0.99 in chips)
Seat 6: lochpo71 (€0.88 in chips)
maritz12: posts small blind €0.01
alvaroa1888: posts big blind €0.02
*** HOLE CARDS ***
Dealt to Luckers712 [Qs 2c]
Benoît S: folds
pinpanculos: folds
lochpo71: folds
Luckers712: folds
maritz12: folds
Uncalled bet (€0.01) returned to alvaroa1888
alvaroa1888 collected €0.02 from pot
alvaroa1888: doesn't show hand
*** SUMMARY ***
Total pot €0.02 | Rake €0
Seat 1: Luckers712 (button) folded before Flop (didn't bet)
Seat 2: maritz12 (small blind) folded before Flop
Seat 3: alvaroa1888 (big blind) collected (€0.02)
Seat 4: Benoît S folded before Flop (didn't bet)
Seat 5: pinpanculos folded before Flop (didn't bet)
Seat 6: lochpo71 folded before Flop (didn't bet)



PokerStars Zoom Hand #210174444644:  Hold'em No Limit (€0.01/€0.02) - 2020/03/15 20:52:00 CET [2020/03/15 15:52:00 ET]
Table 'Arneb' 6-max Seat #1 is the button
Seat 1: 66ocb (€2.63 in chips)
Seat 2: V_Morghuliss (€2.12 in chips)
Seat 3: Luckers712 (€7.61 in chips)
Seat 4: tetar1000d (€2.11 in chips)
Seat 5: Jagf0010 (€2 in chips)
Seat 6: Jou"Yonfa$" (€5.14 in chips)
V_Morghuliss: posts small blind €0.01
Luckers712: posts big blind €0.02
*** HOLE CARDS ***
Dealt to Luckers712 [Qc 8d]
tetar1000d: folds
Jagf0010: folds
Jou"Yonfa$": folds
66ocb: folds
V_Morghuliss: folds
Uncalled bet (€0.01) returned to Luckers712
Luckers712 collected €0.02 from pot
Luckers712: doesn't show hand
*** SUMMARY ***
Total pot €0.02 | Rake €0
Seat 1: 66ocb (button) folded before Flop (didn't bet)
Seat 2: V_Morghuliss (small blind) folded before Flop
Seat 3: Luckers712 (big blind) collected (€0.02)
Seat 4: tetar1000d folded before Flop (didn't bet)
Seat 5: Jagf0010 folded before Flop (didn't bet)
Seat 6: Jou"Yonfa$" folded before Flop (didn't bet)



PokerStars Zoom Hand #210174435288:  Hold'em No Limit (€0.01/€0.02) - 2020/03/15 20:51:50 CET [2020/03/15 15:51:50 ET]
Table 'Arneb' 6-max Seat #1 is the button
Seat 1: pinpanculos (€0.99 in chips)
Seat 2: alfanetworka (€2.60 in chips)
Seat 3: Sweet Answer (€2.35 in chips)
Seat 4: crrio (€1.46 in chips)
Seat 5: Luckers712 (€7.61 in chips)
Seat 6: vit54910 (€0.89 in chips)
alfanetworka: posts small blind €0.01
Sweet Answer: posts big blind €0.02
*** HOLE CARDS ***
Dealt to Luckers712 [2c Qh]
crrio: folds
Luckers712: folds
vit54910: calls €0.02
pinpanculos: folds
alfanetworka: folds
Sweet Answer: checks
*** FLOP *** [Ks Qc 9s]
Sweet Answer: checks
vit54910: bets €0.03
Sweet Answer: calls €0.03
*** TURN *** [Ks Qc 9s] [6d]
Sweet Answer: checks
vit54910: bets €0.04
Sweet Answer: calls €0.04
*** RIVER *** [Ks Qc 9s 6d] [3c]
Sweet Answer: checks
vit54910: bets €0.09
Sweet Answer: folds
Uncalled bet (€0.09) returned to vit54910
vit54910 collected €0.18 from pot
vit54910: doesn't show hand
*** SUMMARY ***
Total pot €0.19 | Rake €0.01
Board [Ks Qc 9s 6d 3c]
Seat 1: pinpanculos (button) folded before Flop (didn't bet)
Seat 2: alfanetworka (small blind) folded before Flop
Seat 3: Sweet Answer (big blind) folded on the River
Seat 4: crrio folded before Flop (didn't bet)
Seat 5: Luckers712 folded before Flop (didn't bet)
Seat 6: vit54910 collected (€0.18)



PokerStars Zoom Hand #210174459622:  Hold'em No Limit (€0.01/€0.02) - 2020/03/15 20:52:16 CET [2020/03/15 15:52:16 ET]
Table 'Arneb' 6-max Seat #1 is the button
Seat 1: Capitan Aab (€2.05 in chips)
Seat 2: andresrodr8 (€2.32 in chips)
Seat 3: colgao87 (€1.32 in chips)
Seat 4: Luckers712 (€7.62 in chips)
Seat 5: Daficko (€2.19 in chips)
Seat 6: fmsrosa4 (€2 in chips)
andresrodr8: posts small blind €0.01
colgao87: posts big blind €0.02
*** HOLE CARDS ***
Dealt to Luckers712 [Ks 9c]
Luckers712: raises €0.03 to €0.05
Daficko: folds
fmsrosa4: folds
Capitan Aab: folds
andresrodr8: folds
colgao87: folds
Uncalled bet (€0.03) returned to Luckers712
Luckers712 collected €0.05 from pot
Luckers712: doesn't show hand
*** SUMMARY ***
Total pot €0.05 | Rake €0
Seat 1: Capitan Aab (button) folded before Flop (didn't bet)
Seat 2: andresrodr8 (small blind) folded before Flop
Seat 3: colgao87 (big blind) folded before Flop
Seat 4: Luckers712 collected (€0.05)
Seat 5: Daficko folded before Flop (didn't bet)
Seat 6: fmsrosa4 folded before Flop (didn't bet)



PokerStars Zoom Hand #210174454924:  Hold'em No Limit (€0.01/€0.02) - 2020/03/15 20:52:11 CET [2020/03/15 15:52:11 ET]
Table 'Arneb' 6-max Seat #1 is the button
Seat 1: Shikamaru003 (€2 in chips)
Seat 2: 5ive x (€2.46 in chips)
Seat 3: manusport (€2.24 in chips)
Seat 4: pope's one (€1.94 in chips)
Seat 5: serafin1824 (€1.27 in chips)
Seat 6: Luckers712 (€7.62 in chips)
5ive x: posts small blind €0.01
manusport: posts big blind €0.02
*** HOLE CARDS ***
Dealt to Luckers712 [Qd 4h]
pope's one: raises €0.04 to €0.06
serafin1824: calls €0.06
Luckers712: folds
Shikamaru003: folds
5ive x: folds
manusport: folds
*** FLOP *** [Jc 9d 8h]
pope's one: bets €0.07
serafin1824: calls €0.07
*** TURN *** [Jc 9d 8h] [Td]
pope's one: bets €0.22
serafin1824: calls €0.22
*** RIVER *** [Jc 9d 8h Td] [8s]
pope's one: bets €0.92
serafin1824: calls €0.92 and is all-in
*** SHOW DOWN ***
pope's one: shows [Qc Jh] (a straight, Eight to Queen)
serafin1824: shows [Kc Qs] (a straight, Nine to King)
serafin1824 collected €2.44 from pot
*** SUMMARY ***
Total pot €2.57 | Rake €0.13
Board [Jc 9d 8h Td 8s]
Seat 1: Shikamaru003 (button) folded before Flop (didn't bet)
Seat 2: 5ive x (small blind) folded before Flop
Seat 3: manusport (big blind) folded before Flop
Seat 4: pope's one showed [Qc Jh] and lost with a straight, Eight to Queen
Seat 5: serafin1824 showed [Kc Qs] and won (€2.44) with a straight, Nine to King
Seat 6: Luckers712 folded before Flop (didn't bet)



PokerStars Zoom Hand #210174479309:  Hold'em No Limit (€0.01/€0.02) - 2020/03/15 20:52:37 CET [2020/03/15 15:52:37 ET]
Table 'Arneb' 6-max Seat #1 is the button
Seat 1: Villano236 (€2.80 in chips)
Seat 2: Luckers712 (€7.65 in chips)
Seat 3: GLICHGAM1NG (€2.02 in chips)
Seat 4: MaurusT (€1.35 in chips)
Seat 5: Anaheras (€2.27 in chips)
Seat 6: Borrachoboy (€2 in chips)
Luckers712: posts small blind €0.01
GLICHGAM1NG: posts big blind €0.02
*** HOLE CARDS ***
Dealt to Luckers712 [5d Kd]
MaurusT: folds
Anaheras: folds
Borrachoboy: folds
Villano236: folds
Luckers712: raises €0.04 to €0.06
GLICHGAM1NG: calls €0.04
*** FLOP *** [Qd Kh 8h]
Luckers712: checks
GLICHGAM1NG: checks
*** TURN *** [Qd Kh 8h] [2h]
Luckers712: bets €0.07
GLICHGAM1NG: folds
Uncalled bet (€0.07) returned to Luckers712
Luckers712 collected €0.11 from pot
Luckers712: doesn't show hand
*** SUMMARY ***
Total pot €0.12 | Rake €0.01
Board [Qd Kh 8h 2h]
Seat 1: Villano236 (button) folded before Flop (didn't bet)
Seat 2: Luckers712 (small blind) collected (€0.11)
Seat 3: GLICHGAM1NG (big blind) folded on the Turn
Seat 4: MaurusT folded before Flop (didn't bet)
Seat 5: Anaheras folded before Flop (didn't bet)
Seat 6: Borrachoboy folded before Flop (didn't bet)



PokerStars Zoom Hand #210174510300:  Hold'em No Limit (€0.01/€0.02) - 2020/03/15 20:53:10 CET [2020/03/15 15:53:10 ET]
Table 'Arneb' 6-max Seat #1 is the button
Seat 1: Luckers712 (€7.70 in chips)
Seat 2: tetar1000d (€3.14 in chips)
Seat 3: jose_hdez11 (€4.36 in chips)
Seat 4: alvaroa1888 (€2 in chips)
Seat 5: Tomz.Turner (€0.19 in chips)
Seat 6: ricmp (€11.35 in chips)
tetar1000d: posts small blind €0.01
jose_hdez11: posts big blind €0.02
*** HOLE CARDS ***
Dealt to Luckers712 [Ad 5h]
alvaroa1888: folds
Tomz.Turner: folds
ricmp: folds
Luckers712: raises €0.04 to €0.06
tetar1000d: raises €0.18 to €0.24
jose_hdez11: folds
Luckers712: folds
Uncalled bet (€0.18) returned to tetar1000d
tetar1000d collected €0.14 from pot
tetar1000d: doesn't show hand
*** SUMMARY ***
Total pot €0.14 | Rake €0
Seat 1: Luckers712 (button) folded before Flop
Seat 2: tetar1000d (small blind) collected (€0.14)
Seat 3: jose_hdez11 (big blind) folded before Flop
Seat 4: alvaroa1888 folded before Flop (didn't bet)
Seat 5: Tomz.Turner folded before Flop (didn't bet)
Seat 6: ricmp folded before Flop (didn't bet)



PokerStars Zoom Hand #210174544095:  Hold'em No Limit (€0.01/€0.02) - 2020/03/15 20:53:46 CET [2020/03/15 15:53:46 ET]
Table 'Arneb' 6-max Seat #1 is the button
Seat 1: Borrachoboy (€2 in chips)
Seat 2: andresrodr8 (€2.20 in chips)
Seat 3: bino mota (€0.91 in chips)
Seat 4: ricmp (€11.36 in chips)
Seat 5: Luckers712 (€7.64 in chips)
Seat 6: Frisar (€0.98 in chips)
andresrodr8: posts small blind €0.01
bino mota: posts big blind €0.02
*** HOLE CARDS ***
Dealt to Luckers712 [4d Td]
ricmp: folds
Luckers712: folds
Frisar: folds
Borrachoboy: raises €0.03 to €0.05
andresrodr8: folds
bino mota: raises €0.86 to €0.91 and is all-in
Borrachoboy: folds
Uncalled bet (€0.86) returned to bino mota
bino mota collected €0.11 from pot
bino mota: doesn't show hand
*** SUMMARY ***
Total pot €0.11 | Rake €0
Seat 1: Borrachoboy (button) folded before Flop
Seat 2: andresrodr8 (small blind) folded before Flop
Seat 3: bino mota (big blind) collected (€0.11)
Seat 4: ricmp folded before Flop (didn't bet)
Seat 5: Luckers712 folded before Flop (didn't bet)
Seat 6: Frisar folded before Flop (didn't bet)



PokerStars Zoom Hand #210174540426:  Hold'em No Limit (€0.01/€0.02) - 2020/03/15 20:53:42 CET [2020/03/15 15:53:42 ET]
Table 'Arneb' 6-max Seat #1 is the button
Seat 1: tetar1000d (€3.22 in chips)
Seat 2: Villano236 (€2 in chips)
Seat 3: ElvasSniper (€2.03 in chips)
Seat 4: javigarrido8 (€2.10 in chips)
Seat 5: BiggieShoot (€4.30 in chips)
Seat 6: Luckers712 (€7.64 in chips)
Villano236: posts small blind €0.01
ElvasSniper: posts big blind €0.02
*** HOLE CARDS ***
Dealt to Luckers712 [3s 7d]
javigarrido8: folds
BiggieShoot: folds
Luckers712: folds
tetar1000d has timed out
tetar1000d: folds
Villano236: folds
Uncalled bet (€0.01) returned to ElvasSniper
ElvasSniper collected €0.02 from pot
ElvasSniper: doesn't show hand
*** SUMMARY ***
Total pot €0.02 | Rake €0
Seat 1: tetar1000d (button) folded before Flop (didn't bet)
Seat 2: Villano236 (small blind) folded before Flop
Seat 3: ElvasSniper (big blind) collected (€0.02)
Seat 4: javigarrido8 folded before Flop (didn't bet)
Seat 5: BiggieShoot folded before Flop (didn't bet)
Seat 6: Luckers712 folded before Flop (didn't bet)



PokerStars Zoom Hand #210174547828:  Hold'em No Limit (€0.01/€0.02) - 2020/03/15 20:53:50 CET [2020/03/15 15:53:50 ET]
Table 'Arneb' 6-max Seat #1 is the button
Seat 1: Jagf0010 (€4.46 in chips)
Seat 2: catalao94 (€1.65 in chips)
Seat 3: Luckers712 (€7.64 in chips)
Seat 4: cañon000 (€1.68 in chips)
Seat 5: levdudinES (€2.06 in chips)
Seat 6: MaurusT (€1.28 in chips)
catalao94: posts small blind €0.01
Luckers712: posts big blind €0.02
*** HOLE CARDS ***
Dealt to Luckers712 [5c As]
cañon000: folds
levdudinES: folds
MaurusT: folds
Jagf0010: raises €0.03 to €0.05
catalao94: folds
Luckers712: calls €0.03
*** FLOP *** [9c 9h 2d]
Luckers712: checks
Jagf0010: checks
*** TURN *** [9c 9h 2d] [7d]
Luckers712: checks
Jagf0010: bets €0.06
Luckers712: calls €0.06
*** RIVER *** [9c 9h 2d 7d] [6c]
Luckers712: checks
Jagf0010: checks
*** SHOW DOWN ***
Luckers712: shows [5c As] (a pair of Nines)
Jagf0010: shows [Ad 7s] (two pair, Nines and Sevens)
Jagf0010 collected €0.22 from pot
*** SUMMARY ***
Total pot €0.23 | Rake €0.01
Board [9c 9h 2d 7d 6c]
Seat 1: Jagf0010 (button) showed [Ad 7s] and won (€0.22) with two pair, Nines and Sevens
Seat 2: catalao94 (small blind) folded before Flop
Seat 3: Luckers712 (big blind) showed [5c As] and lost with a pair of Nines
Seat 4: cañon000 folded before Flop (didn't bet)
Seat 5: levdudinES folded before Flop (didn't bet)
Seat 6: MaurusT folded before Flop (didn't bet)



PokerStars Zoom Hand #210174613192:  Hold'em No Limit (€0.01/€0.02) - 2020/03/15 20:55:00 CET [2020/03/15 15:55:00 ET]
Table 'Arneb' 6-max Seat #1 is the button
Seat 1: WaNtEd_o0 (€1.89 in chips)
Seat 2: Carlslp (€1.56 in chips)
Seat 3: caligurris (€1.60 in chips)
Seat 4: ElvasSniper (€2.01 in chips)
Seat 5: crismatil (€1.96 in chips)
Seat 6: Luckers712 (€7.53 in chips)
Carlslp: posts small blind €0.01
caligurris: posts big blind €0.02
*** HOLE CARDS ***
Dealt to Luckers712 [8c Ac]
ElvasSniper: folds
crismatil: folds
Luckers712: raises €0.03 to €0.05
WaNtEd_o0: folds
Carlslp: folds
caligurris: calls €0.03
*** FLOP *** [4s Ts 6d]
caligurris: checks
Luckers712: checks
*** TURN *** [4s Ts 6d] [4d]
caligurris: checks
Luckers712: checks
*** RIVER *** [4s Ts 6d 4d] [6c]
caligurris: checks
Luckers712: checks
*** SHOW DOWN ***
caligurris: shows [Qh 5d] (two pair, Sixes and Fours)
Luckers712: shows [8c Ac] (two pair, Sixes and Fours - Ace kicker)
Luckers712 collected €0.10 from pot
*** SUMMARY ***
Total pot €0.11 | Rake €0.01
Board [4s Ts 6d 4d 6c]
Seat 1: WaNtEd_o0 (button) folded before Flop (didn't bet)
Seat 2: Carlslp (small blind) folded before Flop
Seat 3: caligurris (big blind) showed [Qh 5d] and lost with two pair, Sixes and Fours
Seat 4: ElvasSniper folded before Flop (didn't bet)
Seat 5: crismatil folded before Flop (didn't bet)
Seat 6: Luckers712 showed [8c Ac] and won (€0.10) with two pair, Sixes and Fours



PokerStars Zoom Hand #210174637631:  Hold'em No Limit (€0.01/€0.02) - 2020/03/15 20:55:39 CET [2020/03/15 15:55:39 ET]
Table 'Arneb' 6-max Seat #1 is the button
Seat 1: DriztDUrden (€1.96 in chips)
Seat 2: perryjason (€2.41 in chips)
Seat 3: Juanfalco98 (€2 in chips)
Seat 4: ricmp (€5.04 in chips)
Seat 5: Luckers712 (€7.57 in chips)
Seat 6: ~mRG^^54 (€2 in chips)
perryjason: posts small blind €0.01
Juanfalco98: posts big blind €0.02
*** HOLE CARDS ***
Dealt to Luckers712 [5s Kd]
ricmp: folds
Luckers712: folds
~mRG^^54: folds
DriztDUrden: folds
perryjason: folds
Uncalled bet (€0.01) returned to Juanfalco98
Juanfalco98 collected €0.02 from pot
Juanfalco98: doesn't show hand
*** SUMMARY ***
Total pot €0.02 | Rake €0
Seat 1: DriztDUrden (button) folded before Flop (didn't bet)
Seat 2: perryjason (small blind) folded before Flop
Seat 3: Juanfalco98 (big blind) collected (€0.02)
Seat 4: ricmp folded before Flop (didn't bet)
Seat 5: Luckers712 folded before Flop (didn't bet)
Seat 6: ~mRG^^54 folded before Flop (didn't bet)



PokerStars Zoom Hand #210174634711:  Hold'em No Limit (€0.01/€0.02) - 2020/03/15 20:55:34 CET [2020/03/15 15:55:34 ET]
Table 'Arneb' 6-max Seat #1 is the button
Seat 1: stonesecuaz (€1.20 in chips)
Seat 2: Luckers712 (€7.58 in chips)
Seat 3: so0tas (€3.27 in chips)
Seat 4: popipat (€2.43 in chips)
Seat 5: Lestat606 (€2.07 in chips)
Seat 6: Shikamaru003 (€3.01 in chips)
Luckers712: posts small blind €0.01
so0tas: posts big blind €0.02
*** HOLE CARDS ***
Dealt to Luckers712 [Jc 3d]
popipat: folds
Lestat606: folds
Shikamaru003: folds
stonesecuaz: calls €0.02
Luckers712: folds
so0tas: checks
*** FLOP *** [7c 9d Qs]
so0tas: bets €0.06
stonesecuaz: folds
Uncalled bet (€0.06) returned to so0tas
so0tas collected €0.05 from pot
so0tas: doesn't show hand
*** SUMMARY ***
Total pot €0.05 | Rake €0
Board [7c 9d Qs]
Seat 1: stonesecuaz (button) folded on the Flop
Seat 2: Luckers712 (small blind) folded before Flop
Seat 3: so0tas (big blind) collected (€0.05)
Seat 4: popipat folded before Flop (didn't bet)
Seat 5: Lestat606 folded before Flop (didn't bet)
Seat 6: Shikamaru003 folded before Flop (didn't bet)



PokerStars Zoom Hand #210174640075:  Hold'em No Limit (€0.01/€0.02) - 2020/03/15 20:55:43 CET [2020/03/15 15:55:43 ET]
Table 'Arneb' 6-max Seat #1 is the button
Seat 1: Jagf0010 (€3.33 in chips)
Seat 2: agus166 (€2 in chips)
Seat 3: Vitorhcsousa (€5.89 in chips)
Seat 4: Luckers712 (€7.57 in chips)
Seat 5: colgao87 (€1.18 in chips)
Seat 6: NWGGY (€1.99 in chips)
agus166: posts small blind €0.01
Vitorhcsousa: posts big blind €0.02
*** HOLE CARDS ***
Dealt to Luckers712 [9h 9d]
Luckers712: raises €0.03 to €0.05
colgao87: folds
NWGGY has timed out
NWGGY: folds
Jagf0010: folds
agus166: raises €0.15 to €0.20
Vitorhcsousa: folds
Luckers712: calls €0.15
*** FLOP *** [Qc 6h 8h]
agus166: bets €0.21
Luckers712: calls €0.21
*** TURN *** [Qc 6h 8h] [7c]
agus166: bets €0.82
Luckers712: raises €6.34 to €7.16 and is all-in
agus166: calls €0.77 and is all-in
Uncalled bet (€5.57) returned to Luckers712
*** RIVER *** [Qc 6h 8h 7c] [Th]
*** SHOW DOWN ***
agus166: shows [Kh Ah] (a flush, Ace high)
Luckers712: shows [9h 9d] (a straight, Six to Ten)
agus166 collected €3.82 from pot
*** SUMMARY ***
Total pot €4.02 | Rake €0.20
Board [Qc 6h 8h 7c Th]
Seat 1: Jagf0010 (button) folded before Flop (didn't bet)
Seat 2: agus166 (small blind) showed [Kh Ah] and won (€3.82) with a flush, Ace high
Seat 3: Vitorhcsousa (big blind) folded before Flop
Seat 4: Luckers712 showed [9h 9d] and lost with a straight, Six to Ten
Seat 5: colgao87 folded before Flop (didn't bet)
Seat 6: NWGGY folded before Flop (didn't bet)



PokerStars Zoom Hand #210174731845:  Hold'em No Limit (€0.01/€0.02) - 2020/03/15 20:58:17 CET [2020/03/15 15:58:17 ET]
Table 'Arneb' 6-max Seat #1 is the button
Seat 1: Luckers712 (€5.55 in chips)
Seat 2: Borrachoboy (€2.04 in chips)
Seat 3: agomez0905 (€4.76 in chips)
Seat 4: eslavoneslavon (€1.81 in chips)
Seat 5: OSXHUM (€1.60 in chips)
Seat 6: andresrodr8 (€2.82 in chips)
Borrachoboy: posts small blind €0.01
agomez0905: posts big blind €0.02
*** HOLE CARDS ***
Dealt to Luckers712 [9d 4h]
eslavoneslavon: folds
OSXHUM: folds
andresrodr8: folds
Luckers712: folds
Borrachoboy: folds
Uncalled bet (€0.01) returned to agomez0905
agomez0905 collected €0.02 from pot
agomez0905: doesn't show hand
*** SUMMARY ***
Total pot €0.02 | Rake €0
Seat 1: Luckers712 (button) folded before Flop (didn't bet)
Seat 2: Borrachoboy (small blind) folded before Flop
Seat 3: agomez0905 (big blind) collected (€0.02)
Seat 4: eslavoneslavon folded before Flop (didn't bet)
Seat 5: OSXHUM folded before Flop (didn't bet)
Seat 6: andresrodr8 folded before Flop (didn't bet)



PokerStars Zoom Hand #210174722835:  Hold'em No Limit (€0.01/€0.02) - 2020/03/15 20:58:02 CET [2020/03/15 15:58:02 ET]
Table 'Arneb' 6-max Seat #1 is the button
Seat 1: maritz12 (€2.38 in chips)
Seat 2: BiggieShoot (€4.03 in chips)
Seat 3: Luckers712 (€5.57 in chips)
Seat 4: Shikamaru003 (€2.97 in chips)
Seat 5: Villano236 (€2.85 in chips)
Seat 6: kelloo01 (€12.10 in chips)
BiggieShoot: posts small blind €0.01
Luckers712: posts big blind €0.02
*** HOLE CARDS ***
Dealt to Luckers712 [9h 3d]
Shikamaru003: folds
Villano236: folds
kelloo01: calls €0.02
maritz12: raises €0.06 to €0.08
BiggieShoot: folds
Luckers712: folds
kelloo01: calls €0.06
*** FLOP *** [8s 9d 8h]
kelloo01: checks
maritz12: checks
*** TURN *** [8s 9d 8h] [4s]
kelloo01: checks
maritz12: checks
*** RIVER *** [8s 9d 8h 4s] [Td]
kelloo01: bets €0.18
maritz12: folds
Uncalled bet (€0.18) returned to kelloo01
kelloo01 collected €0.18 from pot
kelloo01: doesn't show hand
*** SUMMARY ***
Total pot €0.19 | Rake €0.01
Board [8s 9d 8h 4s Td]
Seat 1: maritz12 (button) folded on the River
Seat 2: BiggieShoot (small blind) folded before Flop
Seat 3: Luckers712 (big blind) folded before Flop
Seat 4: Shikamaru003 folded before Flop (didn't bet)
Seat 5: Villano236 folded before Flop (didn't bet)
Seat 6: kelloo01 collected (€0.18)



PokerStars Zoom Hand #210174734236:  Hold'em No Limit (€0.01/€0.02) - 2020/03/15 20:58:21 CET [2020/03/15 15:58:21 ET]
Table 'Arneb' 6-max Seat #1 is the button
Seat 1: ERIZOCACHO (€2.38 in chips)
Seat 2: eslavoneslavon (€1.81 in chips)
Seat 3: TheShrimp8 (€2.44 in chips)
Seat 4: Luckers712 (€5.55 in chips)
Seat 5: xegi (€1.49 in chips)
Seat 6: alexgr1988 (€1.57 in chips)
eslavoneslavon: posts small blind €0.01
TheShrimp8: posts big blind €0.02
*** HOLE CARDS ***
Dealt to Luckers712 [6d 8d]
Luckers712: raises €0.04 to €0.06
xegi: calls €0.06
alexgr1988: calls €0.06
ERIZOCACHO: folds
eslavoneslavon: folds
TheShrimp8: folds
*** FLOP *** [5d Jd Qc]
Luckers712: checks
xegi: bets €0.02
alexgr1988: raises €0.08 to €0.10
Luckers712: calls €0.10
xegi: calls €0.08
*** TURN *** [5d Jd Qc] [3s]
Luckers712: checks
xegi: checks
alexgr1988: bets €0.48
Luckers712: folds
xegi: folds
Uncalled bet (€0.48) returned to alexgr1988
alexgr1988 collected €0.48 from pot
alexgr1988: doesn't show hand
*** SUMMARY ***
Total pot €0.51 | Rake €0.03
Board [5d Jd Qc 3s]
Seat 1: ERIZOCACHO (button) folded before Flop (didn't bet)
Seat 2: eslavoneslavon (small blind) folded before Flop
Seat 3: TheShrimp8 (big blind) folded before Flop
Seat 4: Luckers712 folded on the Turn
Seat 5: xegi folded on the Turn
Seat 6: alexgr1988 collected (€0.48)



PokerStars Zoom Hand #210174780159:  Hold'em No Limit (€0.01/€0.02) - 2020/03/15 20:59:38 CET [2020/03/15 15:59:38 ET]
Table 'Arneb' 6-max Seat #1 is the button
Seat 1: MDKristian (€0.64 in chips)
Seat 2: ERIZOCACHO (€1.19 in chips)
Seat 3: OSXHUM (€1.34 in chips)
Seat 4: jacksparr485 (€5.75 in chips)
Seat 5: Luckers712 (€5.39 in chips)
Seat 6: Borrachoboy (€3.45 in chips)
ERIZOCACHO: posts small blind €0.01
OSXHUM: posts big blind €0.02
*** HOLE CARDS ***
Dealt to Luckers712 [Tc Ac]
jacksparr485 has timed out
jacksparr485: folds
Luckers712: raises €0.03 to €0.05
Borrachoboy: calls €0.05
MDKristian: folds
ERIZOCACHO: folds
OSXHUM: folds
*** FLOP *** [4c Jd 7s]
Luckers712: checks
Borrachoboy: checks
*** TURN *** [4c Jd 7s] [3c]
Luckers712: checks
Borrachoboy: checks
*** RIVER *** [4c Jd 7s 3c] [Jc]
Luckers712: checks
Borrachoboy: checks
*** SHOW DOWN ***
Luckers712: shows [Tc Ac] (a flush, Ace high)
Borrachoboy: mucks hand
Luckers712 collected €0.12 from pot
*** SUMMARY ***
Total pot €0.13 | Rake €0.01
Board [4c Jd 7s 3c Jc]
Seat 1: MDKristian (button) folded before Flop (didn't bet)
Seat 2: ERIZOCACHO (small blind) folded before Flop
Seat 3: OSXHUM (big blind) folded before Flop
Seat 4: jacksparr485 folded before Flop (didn't bet)
Seat 5: Luckers712 showed [Tc Ac] and won (€0.12) with a flush, Ace high
Seat 6: Borrachoboy mucked [Ad Th]



PokerStars Zoom Hand #210174823365:  Hold'em No Limit (€0.01/€0.02) - 2020/03/15 21:00:46 CET [2020/03/15 16:00:46 ET]
Table 'Arneb' 6-max Seat #1 is the button
Seat 1: andresrodr8 (€2.38 in chips)
Seat 2: Luckers712 (€5.46 in chips)
Seat 3: crismatil (€1.77 in chips)
Seat 4: Seron1023 (€3.90 in chips)
Seat 5: capeluche (€1.06 in chips)
Seat 6: toine02000 (€1.46 in chips)
Luckers712: posts small blind €0.01
crismatil: posts big blind €0.02
*** HOLE CARDS ***
Dealt to Luckers712 [As 8s]
Seron1023: folds
capeluche: raises €0.02 to €0.04
toine02000: calls €0.04
andresrodr8: folds
Luckers712: calls €0.03
crismatil: calls €0.02
*** FLOP *** [Kc Jc 2c]
Luckers712: checks
crismatil: checks
capeluche: checks
toine02000: checks
*** TURN *** [Kc Jc 2c] [2s]
Luckers712: checks
crismatil: checks
capeluche: checks
toine02000: checks
*** RIVER *** [Kc Jc 2c 2s] [Qc]
Luckers712 has timed out
Luckers712: checks
crismatil: checks
capeluche: checks
toine02000: checks
*** SHOW DOWN ***
Luckers712: shows [As 8s] (a pair of Deuces)
crismatil: shows [Ks Th] (two pair, Kings and Deuces)
capeluche: mucks hand
toine02000: mucks hand
crismatil collected €0.15 from pot
*** SUMMARY ***
Total pot €0.16 | Rake €0.01
Board [Kc Jc 2c 2s Qc]
Seat 1: andresrodr8 (button) folded before Flop (didn't bet)
Seat 2: Luckers712 (small blind) showed [As 8s] and lost with a pair of Deuces
Seat 3: crismatil (big blind) showed [Ks Th] and won (€0.15) with two pair, Kings and Deuces
Seat 4: Seron1023 folded before Flop (didn't bet)
Seat 5: capeluche mucked [7d 5d]
Seat 6: toine02000 mucked [Ah 4d]



PokerStars Zoom Hand #210174913127:  Hold'em No Limit (€0.01/€0.02) - 2020/03/15 21:02:40 CET [2020/03/15 16:02:40 ET]
Table 'Arneb' 6-max Seat #1 is the button
Seat 1: maximoxuxi (€1.91 in chips)
Seat 2: pope's one (€2.01 in chips)
Seat 3: thehunterfox (€1.45 in chips)
Seat 4: ~mRG^^54 (€2.01 in chips)
Seat 5: Luckers712 (€5.42 in chips)
Seat 6: WaNtEd_o0 (€2.15 in chips)
pope's one: posts small blind €0.01
thehunterfox: posts big blind €0.02
*** HOLE CARDS ***
Dealt to Luckers712 [Js Ah]
~mRG^^54: folds
Luckers712: raises €0.03 to €0.05
WaNtEd_o0: folds
maximoxuxi: folds
pope's one: raises €0.12 to €0.17
thehunterfox: folds
Luckers712: calls €0.12
*** FLOP *** [7d 6s Th]
pope's one: bets €0.17
Luckers712: folds
Uncalled bet (€0.17) returned to pope's one
pope's one collected €0.34 from pot
pope's one: doesn't show hand
*** SUMMARY ***
Total pot €0.36 | Rake €0.02
Board [7d 6s Th]
Seat 1: maximoxuxi (button) folded before Flop (didn't bet)
Seat 2: pope's one (small blind) collected (€0.34)
Seat 3: thehunterfox (big blind) folded before Flop
Seat 4: ~mRG^^54 folded before Flop (didn't bet)
Seat 5: Luckers712 folded on the Flop
Seat 6: WaNtEd_o0 folded before Flop (didn't bet)



PokerStars Zoom Hand #210190487768:  Hold'em No Limit (€0.01/€0.02) - 2020/03/16 3:52:19 CET [2020/03/15 22:52:19 ET]
Table 'Arneb' 6-max Seat #1 is the button
Seat 1: Capitan Aab (€2.08 in chips)
Seat 2: merce7777 (€1.18 in chips)
Seat 3: Luckers712 (€2 in chips)
Seat 4: ERIZOCACHO (€0.84 in chips)
Seat 5: hugoperigoso (€2.28 in chips)
Seat 6: ivancriisto (€1.74 in chips)
merce7777: posts small blind €0.01
Luckers712: posts big blind €0.02
*** HOLE CARDS ***
Dealt to Luckers712 [Qh Qs]
ERIZOCACHO: folds
hugoperigoso: raises €0.05 to €0.07
ivancriisto: folds
Capitan Aab: folds
merce7777: folds
Luckers712: raises €0.13 to €0.20
hugoperigoso: calls €0.13
*** FLOP *** [6d Ad 8h]
Luckers712: bets €0.20
hugoperigoso: folds
Uncalled bet (€0.20) returned to Luckers712
Luckers712 collected €0.39 from pot
Luckers712: doesn't show hand
*** SUMMARY ***
Total pot €0.41 | Rake €0.02
Board [6d Ad 8h]
Seat 1: Capitan Aab (button) folded before Flop (didn't bet)
Seat 2: merce7777 (small blind) folded before Flop
Seat 3: Luckers712 (big blind) collected (€0.39)
Seat 4: ERIZOCACHO folded before Flop (didn't bet)
Seat 5: hugoperigoso folded on the Flop
Seat 6: ivancriisto folded before Flop (didn't bet)



PokerStars Zoom Hand #210190502483:  Hold'em No Limit (€0.01/€0.02) - 2020/03/16 3:53:15 CET [2020/03/15 22:53:15 ET]
Table 'Arneb' 6-max Seat #1 is the button
Seat 1: CHIQUITHÓR (€2.35 in chips)
Seat 2: ivancriisto (€1.78 in chips)
Seat 3: ERIZOCACHO (€2.22 in chips)
Seat 4: PepitoGrillo24 (€2.02 in chips)
Seat 5: VP100_EV- (€6.74 in chips)
Seat 6: Luckers712 (€2.19 in chips)
ivancriisto: posts small blind €0.01
ERIZOCACHO: posts big blind €0.02
*** HOLE CARDS ***
Dealt to Luckers712 [4s 6s]
PepitoGrillo24: folds
VP100_EV-: folds
Luckers712: raises €0.04 to €0.06
CHIQUITHÓR: folds
ivancriisto: folds
ERIZOCACHO: folds
Uncalled bet (€0.04) returned to Luckers712
Luckers712 collected €0.05 from pot
Luckers712: doesn't show hand
*** SUMMARY ***
Total pot €0.05 | Rake €0
Seat 1: CHIQUITHÓR (button) folded before Flop (didn't bet)
Seat 2: ivancriisto (small blind) folded before Flop
Seat 3: ERIZOCACHO (big blind) folded before Flop
Seat 4: PepitoGrillo24 folded before Flop (didn't bet)
Seat 5: VP100_EV- folded before Flop (didn't bet)
Seat 6: Luckers712 collected (€0.05)



PokerStars Zoom Hand #210190507826:  Hold'em No Limit (€0.01/€0.02) - 2020/03/16 3:53:35 CET [2020/03/15 22:53:35 ET]
Table 'Arneb' 6-max Seat #1 is the button
Seat 1: ranchim (€3.19 in chips)
Seat 2: Luckers712 (€2.22 in chips)
Seat 3: tulcio (€2.17 in chips)
Seat 4: ludovic33450 (€3.84 in chips)
Seat 5: CHIQUITHÓR (€2.34 in chips)
Seat 6: batocas96 (€1.37 in chips)
Luckers712: posts small blind €0.01
tulcio: posts big blind €0.02
*** HOLE CARDS ***
Dealt to Luckers712 [5c Jh]
ludovic33450: folds
CHIQUITHÓR: folds
batocas96: folds
ranchim: folds
Luckers712: folds
Uncalled bet (€0.01) returned to tulcio
tulcio collected €0.02 from pot
tulcio: doesn't show hand
*** SUMMARY ***
Total pot €0.02 | Rake €0
Seat 1: ranchim (button) folded before Flop (didn't bet)
Seat 2: Luckers712 (small blind) folded before Flop
Seat 3: tulcio (big blind) collected (€0.02)
Seat 4: ludovic33450 folded before Flop (didn't bet)
Seat 5: CHIQUITHÓR folded before Flop (didn't bet)
Seat 6: batocas96 folded before Flop (didn't bet)



PokerStars Zoom Hand #210190509188:  Hold'em No Limit (€0.01/€0.02) - 2020/03/16 3:53:40 CET [2020/03/15 22:53:40 ET]
Table 'Arneb' 6-max Seat #1 is the button
Seat 1: Luckers712 (€2.21 in chips)
Seat 2: batocas96 (€1.37 in chips)
Seat 3: CHIQUITHÓR (€2.34 in chips)
Seat 4: t0_b3_h0n35T (€1.45 in chips)
Seat 5: jrnapoles (€1.10 in chips)
Seat 6: odaria (€3.32 in chips)
batocas96: posts small blind €0.01
CHIQUITHÓR: posts big blind €0.02
*** HOLE CARDS ***
Dealt to Luckers712 [Qh 3h]
t0_b3_h0n35T: raises €0.04 to €0.06
jrnapoles: folds
odaria: folds
Luckers712: calls €0.06
batocas96: calls €0.05
CHIQUITHÓR: folds
*** FLOP *** [5s 6c 7h]
batocas96: checks
t0_b3_h0n35T: bets €0.14
Luckers712: calls €0.14
batocas96: folds
*** TURN *** [5s 6c 7h] [Th]
t0_b3_h0n35T: bets €0.31
Luckers712: calls €0.31
*** RIVER *** [5s 6c 7h Th] [7d]
t0_b3_h0n35T: bets €0.94 and is all-in
Luckers712: folds
Uncalled bet (€0.94) returned to t0_b3_h0n35T
t0_b3_h0n35T collected €1.04 from pot
t0_b3_h0n35T: doesn't show hand
*** SUMMARY ***
Total pot €1.10 | Rake €0.06
Board [5s 6c 7h Th 7d]
Seat 1: Luckers712 (button) folded on the River
Seat 2: batocas96 (small blind) folded on the Flop
Seat 3: CHIQUITHÓR (big blind) folded before Flop
Seat 4: t0_b3_h0n35T collected (€1.04)
Seat 5: jrnapoles folded before Flop (didn't bet)
Seat 6: odaria folded before Flop (didn't bet)



PokerStars Zoom Hand #210190529357:  Hold'em No Limit (€0.01/€0.02) - 2020/03/16 3:54:21 CET [2020/03/15 22:54:21 ET]
Table 'Arneb' 6-max Seat #1 is the button
Seat 1: CHIQUITHÓR (€2 in chips)
Seat 2: t0_b3_h0n35T (€1.98 in chips)
Seat 3: reKKauudadoR (€3.25 in chips)
Seat 4: nick4tech (€4.39 in chips)
Seat 5: Luckers712 (€1.70 in chips)
Seat 6: pepedopacio (€9.77 in chips)
t0_b3_h0n35T: posts small blind €0.01
reKKauudadoR: posts big blind €0.02
*** HOLE CARDS ***
Dealt to Luckers712 [8s Ah]
nick4tech: folds
Luckers712: folds
pepedopacio: raises €0.04 to €0.06
CHIQUITHÓR: folds
t0_b3_h0n35T: folds
reKKauudadoR: folds
Uncalled bet (€0.04) returned to pepedopacio
pepedopacio collected €0.05 from pot
pepedopacio: doesn't show hand
*** SUMMARY ***
Total pot €0.05 | Rake €0
Seat 1: CHIQUITHÓR (button) folded before Flop (didn't bet)
Seat 2: t0_b3_h0n35T (small blind) folded before Flop
Seat 3: reKKauudadoR (big blind) folded before Flop
Seat 4: nick4tech folded before Flop (didn't bet)
Seat 5: Luckers712 folded before Flop (didn't bet)
Seat 6: pepedopacio collected (€0.05)



PokerStars Zoom Hand #210190531470:  Hold'em No Limit (€0.01/€0.02) - 2020/03/16 3:54:29 CET [2020/03/15 22:54:29 ET]
Table 'Arneb' 6-max Seat #1 is the button
Seat 1: ranchim (€2.62 in chips)
Seat 2: nick4tech (€4.39 in chips)
Seat 3: A8kill (€2.94 in chips)
Seat 4: Luckers712 (€2 in chips)
Seat 5: g.s.rock777 (€5.12 in chips)
Seat 6: Jack el Duro (€3.25 in chips)
nick4tech: posts small blind €0.01
A8kill: posts big blind €0.02
*** HOLE CARDS ***
Dealt to Luckers712 [Jh 4h]
Luckers712: folds
g.s.rock777: calls €0.02
Jack el Duro: folds
ranchim: folds
nick4tech: folds
A8kill: checks
*** FLOP *** [As 6c 2c]
A8kill: checks
g.s.rock777: checks
*** TURN *** [As 6c 2c] [9s]
A8kill: bets €0.03
g.s.rock777: folds
Uncalled bet (€0.03) returned to A8kill
A8kill collected €0.05 from pot
A8kill: doesn't show hand
*** SUMMARY ***
Total pot €0.05 | Rake €0
Board [As 6c 2c 9s]
Seat 1: ranchim (button) folded before Flop (didn't bet)
Seat 2: nick4tech (small blind) folded before Flop
Seat 3: A8kill (big blind) collected (€0.05)
Seat 4: Luckers712 folded before Flop (didn't bet)
Seat 5: g.s.rock777 folded on the Turn
Seat 6: Jack el Duro folded before Flop (didn't bet)



PokerStars Zoom Hand #210190532509:  Hold'em No Limit (€0.01/€0.02) - 2020/03/16 3:54:33 CET [2020/03/15 22:54:33 ET]
Table 'Arneb' 6-max Seat #1 is the button
Seat 1: Mangas88 (€3.96 in chips)
Seat 2: CHIQUITHÓR (€2.53 in chips)
Seat 3: Luckers712 (€2 in chips)
Seat 4: Baby Alligator (€3.33 in chips)
Seat 5: jimmyyyy2800 (€3.46 in chips)
Seat 6: andreonor90 (€1.38 in chips)
CHIQUITHÓR: posts small blind €0.01
Luckers712: posts big blind €0.02
*** HOLE CARDS ***
Dealt to Luckers712 [5c Kc]
Baby Alligator: folds
jimmyyyy2800: folds
andreonor90: raises €0.02 to €0.04
Mangas88: raises €0.11 to €0.15
CHIQUITHÓR: folds
Luckers712: raises €0.25 to €0.40
andreonor90: calls €0.36
Mangas88: calls €0.25
*** FLOP *** [4h 2c 7s]
Luckers712: checks
andreonor90: bets €0.98 and is all-in
Mangas88: folds
Luckers712: folds
Uncalled bet (€0.98) returned to andreonor90
andreonor90 collected €1.15 from pot
*** SUMMARY ***
Total pot €1.21 | Rake €0.06
Board [4h 2c 7s]
Seat 1: Mangas88 (button) folded on the Flop
Seat 2: CHIQUITHÓR (small blind) folded before Flop
Seat 3: Luckers712 (big blind) folded on the Flop
Seat 4: Baby Alligator folded before Flop (didn't bet)
Seat 5: jimmyyyy2800 folded before Flop (didn't bet)
Seat 6: andreonor90 collected (€1.15)



PokerStars Zoom Hand #210190547063:  Hold'em No Limit (€0.01/€0.02) - 2020/03/16 3:55:32 CET [2020/03/15 22:55:32 ET]
Table 'Arneb' 6-max Seat #1 is the button
Seat 1: Luckers712 (€1.60 in chips)
Seat 2: PepitoGrillo24 (€2 in chips)
Seat 3: ERIZOCACHO (€2.26 in chips)
Seat 4: Miltonmoreno (€0.82 in chips)
Seat 5: nick4tech (€2.18 in chips)
Seat 6: odaria (€4.54 in chips)
PepitoGrillo24: posts small blind €0.01
ERIZOCACHO: posts big blind €0.02
*** HOLE CARDS ***
Dealt to Luckers712 [5d 4c]
Miltonmoreno: calls €0.02
nick4tech: raises €0.08 to €0.10
odaria: folds
Luckers712: folds
PepitoGrillo24: folds
ERIZOCACHO: folds
Miltonmoreno: folds
Uncalled bet (€0.08) returned to nick4tech
nick4tech collected €0.07 from pot
nick4tech: doesn't show hand
*** SUMMARY ***
Total pot €0.07 | Rake €0
Seat 1: Luckers712 (button) folded before Flop (didn't bet)
Seat 2: PepitoGrillo24 (small blind) folded before Flop
Seat 3: ERIZOCACHO (big blind) folded before Flop
Seat 4: Miltonmoreno folded before Flop
Seat 5: nick4tech collected (€0.07)
Seat 6: odaria folded before Flop (didn't bet)



PokerStars Zoom Hand #210190549481:  Hold'em No Limit (€0.01/€0.02) - 2020/03/16 3:55:43 CET [2020/03/15 22:55:43 ET]
Table 'Arneb' 6-max Seat #1 is the button
Seat 1: ludovic33450 (€3.90 in chips)
Seat 2: ERIZOCACHO (€2.24 in chips)
Seat 3: fAAQQndo17 (€2 in chips)
Seat 4: kriki515 (€3.86 in chips)
Seat 5: Luckers712 (€1.99 in chips)
Seat 6: Ruperto3 (€1.28 in chips)
ERIZOCACHO: posts small blind €0.01
fAAQQndo17: posts big blind €0.02
*** HOLE CARDS ***
Dealt to Luckers712 [2c 9c]
kriki515: folds
Luckers712: folds
Ruperto3: folds
ludovic33450: folds
ERIZOCACHO: folds
Uncalled bet (€0.01) returned to fAAQQndo17
fAAQQndo17 collected €0.02 from pot
fAAQQndo17: doesn't show hand
*** SUMMARY ***
Total pot €0.02 | Rake €0
Seat 1: ludovic33450 (button) folded before Flop (didn't bet)
Seat 2: ERIZOCACHO (small blind) folded before Flop
Seat 3: fAAQQndo17 (big blind) collected (€0.02)
Seat 4: kriki515 folded before Flop (didn't bet)
Seat 5: Luckers712 folded before Flop (didn't bet)
Seat 6: Ruperto3 folded before Flop (didn't bet)



PokerStars Zoom Hand #210190551661:  Hold'em No Limit (€0.01/€0.02) - 2020/03/16 3:55:53 CET [2020/03/15 22:55:53 ET]
Table 'Arneb' 6-max Seat #1 is the button
Seat 1: pepedopacio (€3.48 in chips)
Seat 2: Polo40400 (€4.13 in chips)
Seat 3: ivancriisto (€1.60 in chips)
Seat 4: tulcio (€2 in chips)
Seat 5: kriki515 (€2.52 in chips)
Seat 6: Luckers712 (€1.99 in chips)
Polo40400: posts small blind €0.01
ivancriisto: posts big blind €0.02
*** HOLE CARDS ***
Dealt to Luckers712 [9h 5s]
tulcio: folds
kriki515: folds
Luckers712: folds
pepedopacio: folds
Polo40400: folds
Uncalled bet (€0.01) returned to ivancriisto
ivancriisto collected €0.02 from pot
ivancriisto: doesn't show hand
*** SUMMARY ***
Total pot €0.02 | Rake €0
Seat 1: pepedopacio (button) folded before Flop (didn't bet)
Seat 2: Polo40400 (small blind) folded before Flop
Seat 3: ivancriisto (big blind) collected (€0.02)
Seat 4: tulcio folded before Flop (didn't bet)
Seat 5: kriki515 folded before Flop (didn't bet)
Seat 6: Luckers712 folded before Flop (didn't bet)



PokerStars Zoom Hand #210190548591:  Hold'em No Limit (€0.01/€0.02) - 2020/03/16 3:55:39 CET [2020/03/15 22:55:39 ET]
Table 'Arneb' 6-max Seat #1 is the button
Seat 1: ranchim (€2.59 in chips)
Seat 2: Luckers712 (€2 in chips)
Seat 3: merce7777 (€1.05 in chips)
Seat 4: Zziiggy (€7.41 in chips)
Seat 5: odaria (€4.54 in chips)
Seat 6: tulcio (€2 in chips)
Luckers712: posts small blind €0.01
merce7777: posts big blind €0.02
*** HOLE CARDS ***
Dealt to Luckers712 [Jh 8c]
Zziiggy: folds
odaria: calls €0.02
tulcio: folds
ranchim: folds
Luckers712: folds
merce7777: raises €0.02 to €0.04
odaria: calls €0.02
*** FLOP *** [Ac As 8d]
merce7777: checks
odaria: checks
*** TURN *** [Ac As 8d] [3d]
merce7777: checks
odaria: checks
*** RIVER *** [Ac As 8d 3d] [4s]
merce7777: bets €0.12
odaria: folds
Uncalled bet (€0.12) returned to merce7777
merce7777 collected €0.09 from pot
merce7777: doesn't show hand
*** SUMMARY ***
Total pot €0.09 | Rake €0
Board [Ac As 8d 3d 4s]
Seat 1: ranchim (button) folded before Flop (didn't bet)
Seat 2: Luckers712 (small blind) folded before Flop
Seat 3: merce7777 (big blind) collected (€0.09)
Seat 4: Zziiggy folded before Flop (didn't bet)
Seat 5: odaria folded on the River
Seat 6: tulcio folded before Flop (didn't bet)



PokerStars Zoom Hand #210190550595:  Hold'em No Limit (€0.01/€0.02) - 2020/03/16 3:55:48 CET [2020/03/15 22:55:48 ET]
Table 'Arneb' 6-max Seat #1 is the button
Seat 1: nick4tech (€2.23 in chips)
Seat 2: Zziiggy (€7.41 in chips)
Seat 3: pirámides22 (€1.34 in chips)
Seat 4: Luckers712 (€1.99 in chips)
Seat 5: Miltonmoreno (€1.34 in chips)
Seat 6: ludovic33450 (€3.90 in chips)
Zziiggy: posts small blind €0.01
pirámides22: posts big blind €0.02
*** HOLE CARDS ***
Dealt to Luckers712 [2h 3s]
Luckers712: folds
Miltonmoreno: calls €0.02
ludovic33450: folds
nick4tech: folds
Zziiggy: folds
pirámides22: checks
*** FLOP *** [Ts Kh 6d]
pirámides22: checks
Miltonmoreno: checks
*** TURN *** [Ts Kh 6d] [Qs]
pirámides22: checks
Miltonmoreno: checks
*** RIVER *** [Ts Kh 6d Qs] [Qd]
pirámides22: checks
Miltonmoreno: checks
*** SHOW DOWN ***
pirámides22: shows [6s 9c] (two pair, Queens and Sixes)
Miltonmoreno: mucks hand
pirámides22 collected €0.05 from pot
*** SUMMARY ***
Total pot €0.05 | Rake €0
Board [Ts Kh 6d Qs Qd]
Seat 1: nick4tech (button) folded before Flop (didn't bet)
Seat 2: Zziiggy (small blind) folded before Flop
Seat 3: pirámides22 (big blind) showed [6s 9c] and won (€0.05) with two pair, Queens and Sixes
Seat 4: Luckers712 folded before Flop (didn't bet)
Seat 5: Miltonmoreno mucked [Ah 2d]
Seat 6: ludovic33450 folded before Flop (didn't bet)



PokerStars Zoom Hand #210190555808:  Hold'em No Limit (€0.01/€0.02) - 2020/03/16 3:56:12 CET [2020/03/15 22:56:12 ET]
Table 'Arneb' 6-max Seat #1 is the button
Seat 1: PepitoGrillo24 (€0.85 in chips)
Seat 2: Luckers712 (€1.98 in chips)
Seat 3: ludovic33450 (€3.90 in chips)
Seat 4: kriki515 (€2.52 in chips)
Seat 5: luis.M27500 (€1.07 in chips)
Seat 6: pepedopacio (€3.47 in chips)
Luckers712: posts small blind €0.01
ludovic33450: posts big blind €0.02
*** HOLE CARDS ***
Dealt to Luckers712 [Ac 8d]
kriki515: calls €0.02
luis.M27500: calls €0.02
pepedopacio: folds
PepitoGrillo24: raises €0.83 to €0.85 and is all-in
Luckers712: folds
ludovic33450: folds
kriki515: folds
luis.M27500: folds
Uncalled bet (€0.83) returned to PepitoGrillo24
PepitoGrillo24 collected €0.09 from pot
PepitoGrillo24: doesn't show hand
*** SUMMARY ***
Total pot €0.09 | Rake €0
Seat 1: PepitoGrillo24 (button) collected (€0.09)
Seat 2: Luckers712 (small blind) folded before Flop
Seat 3: ludovic33450 (big blind) folded before Flop
Seat 4: kriki515 folded before Flop
Seat 5: luis.M27500 folded before Flop
Seat 6: pepedopacio folded before Flop (didn't bet)



PokerStars Zoom Hand #210190552550:  Hold'em No Limit (€0.01/€0.02) - 2020/03/16 3:55:57 CET [2020/03/15 22:55:57 ET]
Table 'Arneb' 6-max Seat #1 is the button
Seat 1: Polo40400 (€4.12 in chips)
Seat 2: merce7777 (€0.94 in chips)
Seat 3: levezinho32 (€1 in chips)
Seat 4: ranchim (€3.19 in chips)
Seat 5: Luckers712 (€1.99 in chips)
Seat 6: A8kill (€2.79 in chips)
merce7777: posts small blind €0.01
levezinho32: posts big blind €0.02
*** HOLE CARDS ***
Dealt to Luckers712 [Kd 5s]
ranchim: calls €0.02
Luckers712: folds
A8kill: folds
Polo40400: folds
merce7777: calls €0.01
levezinho32: checks
*** FLOP *** [Ad 7c 4d]
merce7777: checks
levezinho32: checks
ranchim: bets €0.06
merce7777: folds
levezinho32: folds
Uncalled bet (€0.06) returned to ranchim
ranchim collected €0.06 from pot
ranchim: doesn't show hand
*** SUMMARY ***
Total pot €0.06 | Rake €0
Board [Ad 7c 4d]
Seat 1: Polo40400 (button) folded before Flop (didn't bet)
Seat 2: merce7777 (small blind) folded on the Flop
Seat 3: levezinho32 (big blind) folded on the Flop
Seat 4: ranchim collected (€0.06)
Seat 5: Luckers712 folded before Flop (didn't bet)
Seat 6: A8kill folded before Flop (didn't bet)



PokerStars Zoom Hand #210190553429:  Hold'em No Limit (€0.01/€0.02) - 2020/03/16 3:56:01 CET [2020/03/15 22:56:01 ET]
Table 'Arneb' 6-max Seat #1 is the button
Seat 1: nick4tech (€5.21 in chips)
Seat 2: romananna119 (€4.51 in chips)
Seat 3: Luckers712 (€1.99 in chips)
Seat 4: Jou"Yonfa$" (€9.37 in chips)
Seat 5: Zziiggy (€7.40 in chips)
Seat 6: Polo40400 (€4.12 in chips)
romananna119: posts small blind €0.01
Luckers712: posts big blind €0.02
*** HOLE CARDS ***
Dealt to Luckers712 [3h 9c]
Jou"Yonfa$": folds
Zziiggy: folds
Polo40400: raises €0.04 to €0.06
nick4tech: folds
romananna119: calls €0.05
Luckers712: folds
*** FLOP *** [As Tc 8h]
romananna119: checks
Polo40400: bets €0.04
romananna119: calls €0.04
*** TURN *** [As Tc 8h] [Ad]
romananna119: checks
Polo40400: checks
*** RIVER *** [As Tc 8h Ad] [6h]
romananna119: bets €0.02
Polo40400: calls €0.02
*** SHOW DOWN ***
romananna119: shows [Qc Ts] (two pair, Aces and Tens)
Polo40400: mucks hand
romananna119 collected €0.25 from pot
*** SUMMARY ***
Total pot €0.26 | Rake €0.01
Board [As Tc 8h Ad 6h]
Seat 1: nick4tech (button) folded before Flop (didn't bet)
Seat 2: romananna119 (small blind) showed [Qc Ts] and won (€0.25) with two pair, Aces and Tens
Seat 3: Luckers712 (big blind) folded before Flop
Seat 4: Jou"Yonfa$" folded before Flop (didn't bet)
Seat 5: Zziiggy folded before Flop (didn't bet)
Seat 6: Polo40400 mucked [Kd 6d]



PokerStars Zoom Hand #210190560208:  Hold'em No Limit (€0.01/€0.02) - 2020/03/16 3:56:32 CET [2020/03/15 22:56:32 ET]
Table 'Arneb' 6-max Seat #1 is the button
Seat 1: Luckers712 (€1.97 in chips)
Seat 2: Jou"Yonfa$" (€5.82 in chips)
Seat 3: Pollotronc (€1.38 in chips)
Seat 4: pepedopacio (€7.46 in chips)
Seat 5: PepitoGrillo24 (€0.92 in chips)
Seat 6: ranchim (€2.81 in chips)
Jou"Yonfa$": posts small blind €0.01
Pollotronc: posts big blind €0.02
*** HOLE CARDS ***
Dealt to Luckers712 [Tc 9c]
pepedopacio: folds
PepitoGrillo24: folds
ranchim: folds
Luckers712: raises €0.03 to €0.05
Jou"Yonfa$": folds
Pollotronc: calls €0.03
*** FLOP *** [6s 5d 6d]
Pollotronc: checks
Luckers712: checks
*** TURN *** [6s 5d 6d] [8s]
Pollotronc: checks
Luckers712: checks
*** RIVER *** [6s 5d 6d 8s] [Ac]
Pollotronc: checks
Luckers712: bets €0.05
Pollotronc: calls €0.05
*** SHOW DOWN ***
Luckers712: shows [Tc 9c] (a pair of Sixes)
Pollotronc: shows [4s Kd] (a pair of Sixes - Ace+King kicker)
Pollotronc collected €0.20 from pot
*** SUMMARY ***
Total pot €0.21 | Rake €0.01
Board [6s 5d 6d 8s Ac]
Seat 1: Luckers712 (button) showed [Tc 9c] and lost with a pair of Sixes
Seat 2: Jou"Yonfa$" (small blind) folded before Flop
Seat 3: Pollotronc (big blind) showed [4s Kd] and won (€0.20) with a pair of Sixes
Seat 4: pepedopacio folded before Flop (didn't bet)
Seat 5: PepitoGrillo24 folded before Flop (didn't bet)
Seat 6: ranchim folded before Flop (didn't bet)



PokerStars Zoom Hand #210190570655:  Hold'em No Limit (€0.01/€0.02) - 2020/03/16 3:57:20 CET [2020/03/15 22:57:20 ET]
Table 'Arneb' 6-max Seat #1 is the button
Seat 1: JRTDCF#2 (€1.51 in chips)
Seat 2: Pollotronc (€1.48 in chips)
Seat 3: CHIQUITHÓR (€2 in chips)
Seat 4: Luckers712 (€1.90 in chips)
Seat 5: Ruperto3 (€1.29 in chips)
Seat 6: levezinho32 (€0.94 in chips)
Pollotronc: posts small blind €0.01
CHIQUITHÓR: posts big blind €0.02
*** HOLE CARDS ***
Dealt to Luckers712 [7d 4c]
Luckers712: folds
Ruperto3: folds
levezinho32: folds
JRTDCF#2: folds
Pollotronc: folds
Uncalled bet (€0.01) returned to CHIQUITHÓR
CHIQUITHÓR collected €0.02 from pot
CHIQUITHÓR: doesn't show hand
*** SUMMARY ***
Total pot €0.02 | Rake €0
Seat 1: JRTDCF#2 (button) folded before Flop (didn't bet)
Seat 2: Pollotronc (small blind) folded before Flop
Seat 3: CHIQUITHÓR (big blind) collected (€0.02)
Seat 4: Luckers712 folded before Flop (didn't bet)
Seat 5: Ruperto3 folded before Flop (didn't bet)
Seat 6: levezinho32 folded before Flop (didn't bet)



PokerStars Zoom Hand #210190572097:  Hold'em No Limit (€0.01/€0.02) - 2020/03/16 3:57:27 CET [2020/03/15 22:57:27 ET]
Table 'Arneb' 6-max Seat #1 is the button
Seat 1: brujAAveriia (€1.62 in chips)
Seat 2: alvaroa1888 (€2 in chips)
Seat 3: Baby Alligator (€3.71 in chips)
Seat 4: ranchim (€5.65 in chips)
Seat 5: CHIQUITHÓR (€2 in chips)
Seat 6: Luckers712 (€2 in chips)
alvaroa1888: posts small blind €0.01
Baby Alligator: posts big blind €0.02
*** HOLE CARDS ***
Dealt to Luckers712 [7h 9h]
ranchim: raises €0.04 to €0.06
CHIQUITHÓR has timed out while disconnected
CHIQUITHÓR: folds
Luckers712: raises €0.12 to €0.18
brujAAveriia: folds
alvaroa1888: folds
Baby Alligator: folds
ranchim: calls €0.12
*** FLOP *** [Qh Jd 4d]
ranchim: checks
Luckers712: checks
*** TURN *** [Qh Jd 4d] [2d]
ranchim: checks
Luckers712: checks
*** RIVER *** [Qh Jd 4d 2d] [Ac]
ranchim: bets €0.37
Luckers712: raises €0.63 to €1
ranchim: calls €0.63
*** SHOW DOWN ***
Luckers712: shows [7h 9h] (high card Ace)
ranchim: shows [Th Kh] (a straight, Ten to Ace)
ranchim collected €2.27 from pot
*** SUMMARY ***
Total pot €2.39 | Rake €0.12
Board [Qh Jd 4d 2d Ac]
Seat 1: brujAAveriia (button) folded before Flop (didn't bet)
Seat 2: alvaroa1888 (small blind) folded before Flop
Seat 3: Baby Alligator (big blind) folded before Flop
Seat 4: ranchim showed [Th Kh] and won (€2.27) with a straight, Ten to Ace
Seat 5: CHIQUITHÓR folded before Flop (didn't bet)
Seat 6: Luckers712 showed [7h 9h] and lost with high card Ace




